call,qsos_submitted,qsos_dropped,qsos_valid,cw_qso,cw_qso_pts,ph_qso,ph_qso_pts,total_qso_pts,gs_1,gs_3,gs_7,gs_14,gs_21,gs_28,gs_50,total_gs,operated_totality,operated_outdoors,operated_public,ground_conductivity,antenna_design,erpd,skimmers,iq_data,total
AA1K,56,0,56,56,112,0,0,112,18,0,0,29,2,0,0,49,100,100,100,50,0,0,0,0,5838
AA2MF,152,0,152,152,304,0,0,304,0,0,4,65,0,0,0,69,100,100,100,50,0,100,0,0,21426
AA3B,680,0,680,680,1360,0,0,1360,1,23,99,160,12,1,0,296,100,100,100,50,100,300,0,0,403310
AA3WB,24,0,24,0,0,24,24,24,0,0,14,6,0,0,0,20,100,100,100,50,100,0,0,0,930
AA4LR,61,1,60,52,104,8,8,112,0,0,20,29,4,1,0,54,100,100,100,50,0,200,0,0,6598
AA5AD,27,0,27,27,54,0,0,54,0,0,0,19,0,0,0,19,100,100,100,0,0,0,0,0,1326
AA5VN,21,0,21,21,42,0,0,42,0,0,0,15,0,0,0,15,100,100,100,0,0,0,0,0,930
AA9K,18,0,18,18,36,0,0,36,0,0,13,0,0,0,0,13,100,100,100,50,0,0,0,0,818
AB1J,27,0,27,27,54,0,0,54,0,0,13,1,0,0,0,14,100,100,100,50,0,0,0,0,1106
AB3GY,79,1,78,78,156,0,0,156,0,0,51,1,0,0,0,52,100,100,100,50,0,100,100,0,8662
AB3RU,8,0,8,8,16,0,0,16,0,0,4,4,0,0,0,8,100,100,100,50,0,0,0,0,478
AB4VT,14,0,14,10,20,4,4,24,0,0,2,12,0,0,0,14,100,100,100,50,0,100,0,0,786
AB5J,172,0,172,13,26,159,159,185,0,0,0,95,0,0,0,95,100,100,100,50,100,100,0,0,18125
AB5XM,6,0,6,6,12,0,0,12,0,0,0,6,0,0,0,6,100,100,100,50,0,0,0,0,422
AB7WP,4,0,4,0,0,4,4,4,0,1,3,0,0,0,0,4,100,100,100,50,0,0,0,0,366
AB9CA,54,0,54,54,108,0,0,108,0,0,35,0,0,0,0,35,100,100,100,0,0,0,0,0,4080
AB9PR,10,0,10,0,0,10,10,10,0,0,0,9,0,0,0,9,100,100,100,50,0,0,0,0,440
AB9YC,100,0,100,100,200,0,0,200,0,1,20,46,0,0,0,67,100,100,100,0,0,0,0,0,13700
AB9ZZ,37,1,36,36,72,0,0,72,0,0,0,29,0,0,0,29,100,100,100,0,0,0,0,0,2388
AC0PR,18,0,18,18,36,0,0,36,0,0,0,17,0,0,0,17,100,100,100,0,0,0,0,0,912
AC7AF,49,0,49,49,98,0,0,98,0,0,7,33,1,0,0,41,100,100,100,0,100,0,0,0,4418
AC8JW,14,0,14,14,28,0,0,28,0,0,3,11,0,0,0,14,100,100,100,50,0,0,0,0,742
AC9AK,13,0,13,7,14,6,6,20,0,0,0,12,0,0,0,12,100,100,100,50,0,0,0,0,590
AD0P,87,62,25,23,46,2,2,48,0,0,0,1,0,0,0,1,100,100,100,50,0,50,50,0,498
AD0TA,36,18,18,18,36,0,0,36,0,0,0,15,0,0,0,15,100,100,100,50,0,50,0,0,940
AD4TJ,30,15,15,15,30,0,0,30,0,0,0,13,0,0,0,13,100,100,100,50,100,50,0,0,890
AD5KZ,4,2,2,0,0,2,2,2,0,0,0,2,0,0,0,2,100,100,100,50,0,0,0,0,354
AD5XD,83,10,73,73,146,0,0,146,0,0,0,52,0,0,0,52,100,100,100,50,0,50,0,0,7992
AD6ZR,17,0,17,17,34,0,0,34,0,0,0,15,0,0,0,15,100,100,100,0,0,0,0,0,810
AD7KG,33,0,33,17,34,16,16,50,0,0,0,24,0,0,0,24,100,100,100,50,0,0,0,0,1550
AE1T,176,0,176,175,350,1,1,351,0,7,28,88,0,0,0,123,100,100,100,50,100,150,0,0,43773
AE3J,11,0,11,11,22,0,0,22,0,0,7,4,0,0,0,11,100,100,100,50,0,100,0,0,692
AE5MI,37,0,37,37,74,0,0,74,0,0,0,27,0,0,0,27,100,100,100,0,0,0,0,0,2298
AE9LL,3,0,3,3,6,0,0,6,0,0,1,2,0,0,0,3,100,100,100,50,0,250,0,0,618
AF0E/7,39,1,38,38,76,0,0,76,0,0,0,32,0,0,0,32,100,100,100,0,0,0,0,0,2732
AF4HL,3,0,3,3,6,0,0,6,0,0,0,2,1,0,0,3,100,100,100,50,0,0,0,0,368
AF4MP/M,9,0,9,0,0,9,9,9,0,0,9,0,0,0,0,9,100,100,100,50,0,0,0,0,431
AF6HC,2,0,2,1,2,1,1,3,0,0,0,1,0,0,0,1,100,100,100,0,0,0,0,0,303
AF8A,33,0,33,33,66,0,0,66,0,2,9,19,0,0,0,30,100,100,100,0,0,0,0,0,2280
AG6RS,16,1,15,15,30,0,0,30,0,0,0,12,0,0,0,12,100,100,100,0,0,0,0,0,660
AG7GP,50,0,50,0,0,50,50,50,0,0,25,14,0,0,0,39,100,100,100,50,100,0,0,0,2400
AI6IN,12,0,12,0,0,12,12,12,0,0,0,10,0,0,0,10,100,100,100,50,0,50,50,0,570
AI6LY,130,5,125,0,0,125,125,125,0,0,6,82,0,0,0,88,100,100,100,50,0,100,0,0,11450
AI6SL,15,0,15,15,30,0,0,30,0,0,1,13,0,0,0,14,100,100,100,0,0,0,0,0,720
AJ3C,15,0,15,15,30,0,0,30,0,0,0,14,0,0,0,14,100,100,100,0,0,0,0,0,720
AJ4PW,36,6,30,0,0,30,30,30,0,0,1,25,0,0,0,26,100,100,100,0,0,0,0,0,1080
AJ6T,22,1,21,21,42,0,0,42,0,0,0,12,0,0,0,12,100,100,100,50,0,50,0,0,904
AK0W,10,0,10,10,20,0,0,20,0,0,0,10,0,0,0,10,100,100,100,50,0,50,50,0,650
AK4NG,9,0,9,9,18,0,0,18,0,0,3,5,0,0,0,8,100,100,100,50,100,0,0,0,594
AK5Y,73,4,69,69,138,0,0,138,0,0,0,42,1,0,0,43,100,100,100,50,0,50,0,0,6334
AK7O,61,2,59,59,118,0,0,118,0,0,0,40,0,0,0,40,100,100,100,0,0,50,0,0,5070
AL7LO,57,0,57,56,112,1,1,113,0,0,0,39,0,0,0,39,100,100,100,50,0,50,0,0,4807
CG3ZN,17,0,17,1,2,16,16,18,0,0,7,8,0,0,0,15,100,100,100,0,100,0,0,0,670
CT7AIX,8,0,8,8,16,0,0,16,0,0,0,8,0,0,0,8,100,100,100,0,0,0,0,0,428
EA3/SP5ULN,16,0,16,16,32,0,0,32,0,0,0,16,0,0,0,16,100,100,100,50,100,0,0,0,962
F1ABL,43,0,43,43,86,0,0,86,0,0,1,1,1,0,0,3,100,100,100,0,0,150,100,150,958
G3LDI,23,0,23,23,46,0,0,46,0,0,0,20,0,0,0,20,100,100,100,0,0,0,0,0,1220
G3UCQ,21,0,21,21,42,0,0,42,0,0,0,20,0,0,0,20,100,100,100,0,0,0,0,0,1140
G4GIR,9,0,9,9,18,0,0,18,0,0,0,9,0,0,0,9,100,100,100,0,0,0,0,0,462
G4KRW,24,10,14,14,28,0,0,28,0,0,14,0,0,0,0,14,100,100,100,50,0,0,0,0,742
K0ALB,1,1,0,0,0,0,0,0,0,0,0,0,0,0,0,0,100,100,100,0,0,0,0,0,300
K0AV,29,14,15,14,28,1,1,29,0,0,6,9,0,0,0,15,100,100,100,50,100,100,0,0,985
K0DTJ,97,22,75,75,150,0,0,150,0,2,19,38,0,0,0,59,100,100,100,0,0,150,0,0,9300
K0GUZ,15,0,15,15,30,0,0,30,0,0,7,7,0,0,0,14,100,100,100,0,0,0,0,0,720
K0GW,9,0,9,9,18,0,0,18,0,0,0,8,0,0,0,8,100,100,100,0,0,0,0,0,444
K0JY,48,0,48,48,96,0,0,96,0,0,0,22,0,0,0,22,100,100,100,0,100,0,0,0,2512
K0SAU,11,1,10,10,20,0,0,20,0,0,0,7,0,0,0,7,100,100,100,50,0,0,0,0,490
K0TQ,21,0,21,21,42,0,0,42,0,0,18,1,0,0,0,19,100,100,100,50,0,0,0,0,1148
K0UA,16,0,16,0,0,16,16,16,0,0,3,13,0,0,0,16,100,100,100,50,0,0,0,0,606
K0USA,59,1,58,0,0,58,58,58,0,0,0,45,0,0,0,45,100,100,100,50,0,50,0,0,3010
K0VH,16,1,15,9,18,6,6,24,0,0,0,14,0,0,0,14,100,100,100,50,0,150,0,0,836
K1AUS,4,0,4,0,0,4,4,4,0,0,0,4,0,0,0,4,100,100,100,50,0,250,0,0,616
K1EEE,175,1,174,174,348,0,0,348,0,0,0,0,0,0,0,0,100,100,100,50,0,150,0,0,500
K1LOL,33,0,33,33,66,0,0,66,0,0,10,23,0,0,0,33,100,100,100,50,0,0,0,0,2528
K1LT,118,0,118,118,236,0,0,236,0,0,66,0,0,0,0,66,100,100,100,0,0,0,0,0,15876
K1NKR,5,0,5,0,0,5,5,5,0,0,5,0,0,0,0,5,100,100,100,50,0,50,100,0,525
K1NPT,26,2,24,24,48,0,0,48,0,4,14,2,0,0,0,20,100,100,100,50,0,150,500,0,1960
K1NZ,3,0,3,3,6,0,0,6,0,0,3,0,0,0,0,3,100,100,100,0,0,0,0,0,318
K1OTZ,10,1,9,9,18,0,0,18,0,0,0,3,0,0,0,3,100,100,100,50,0,0,0,0,404
K1RV,77,0,77,77,154,0,0,154,2,7,22,19,1,0,0,51,100,100,100,50,0,0,0,0,8204
K1XRN,12,0,12,10,20,2,2,22,0,0,12,0,0,0,0,12,100,100,100,0,0,0,0,0,564
K2AA,44,0,44,35,70,9,9,79,0,0,7,29,0,0,0,36,100,100,100,50,0,100,0,0,3294
K2CIB,173,8,165,10,20,155,155,175,0,0,0,91,0,0,0,91,100,100,100,50,100,50,0,0,16425
K2DSW,308,0,308,308,616,0,0,616,0,0,65,100,0,0,0,165,100,100,100,0,0,0,0,0,101940
K2GLS,14,0,14,14,28,0,0,28,0,0,2,10,0,0,0,12,100,100,100,50,0,250,0,0,936
K2HVE,11,0,11,0,0,11,11,11,0,0,8,0,0,0,0,8,100,100,100,0,0,50,0,0,438
K2LE/1,221,11,210,210,420,0,0,420,0,10,14,110,13,0,0,147,100,100,100,0,0,0,0,0,62040
K2ND,27,0,27,27,54,0,0,54,0,0,11,15,0,0,0,26,100,100,100,50,0,250,0,0,2004
K2OID,42,2,40,40,80,0,0,80,0,0,11,19,0,0,0,30,100,100,100,0,0,50,0,0,2750
K2PAA,26,4,22,22,44,0,0,44,0,0,0,15,0,0,0,15,100,100,100,50,100,50,0,0,1160
K2PS,50,7,43,43,86,0,0,86,0,0,21,12,2,0,0,35,100,100,100,50,0,0,0,0,3360
K2QPN,17,0,17,17,34,0,0,34,0,0,0,17,0,0,0,17,100,100,100,50,0,50,50,50,1078
K2RYD,10,0,10,0,0,10,10,10,0,0,2,4,0,0,0,6,100,100,100,50,0,0,0,0,410
K2WK,100,2,98,98,196,0,0,196,0,13,17,40,4,0,0,74,100,100,100,0,0,200,0,0,15004
K3PP,71,1,70,70,140,0,0,140,0,30,17,0,0,0,0,47,100,100,100,50,0,0,0,0,6930
K3RRP,5,0,5,0,0,5,5,5,0,0,2,2,0,0,0,4,100,100,100,50,0,0,0,0,370
K3TW,1,0,1,1,2,0,0,2,0,1,0,0,0,0,0,1,100,100,100,0,0,0,0,0,302
K3VX,26,0,26,26,52,0,0,52,0,0,6,17,0,0,0,23,100,100,100,50,0,100,0,0,1646
K3WR,56,0,56,53,106,3,3,109,0,0,0,38,0,0,0,38,100,100,100,50,0,0,0,0,4492
K3ZO,233,1,232,232,464,0,0,464,0,23,37,99,0,0,0,159,100,100,100,50,100,0,0,0,74226
K4BAI,454,1,453,453,906,0,0,906,3,14,80,145,5,0,0,247,100,100,100,0,0,0,0,0,224082
K4E,40,0,40,28,56,12,12,68,0,0,27,11,0,0,0,38,100,100,100,50,0,0,0,0,2934
K4FTP,46,1,45,45,90,0,0,90,0,0,8,31,0,0,2,41,100,100,100,0,0,0,0,0,3990
K4GSX,8,0,8,8,16,0,0,16,0,0,8,0,0,0,0,8,100,100,100,50,100,50,0,0,628
K4JWX,9,0,9,0,0,9,9,9,0,0,0,8,0,0,0,8,100,100,100,50,0,50,0,0,472
K4LNN,42,1,41,34,68,7,7,75,0,0,0,33,0,0,0,33,100,100,100,0,0,0,0,0,2775
K4NAX,77,1,76,76,152,0,0,152,0,0,38,15,0,0,0,53,100,100,100,0,0,0,0,0,8356
K4RUM,44,0,44,44,88,0,0,88,0,0,5,31,1,0,0,37,100,100,100,0,0,0,0,0,3556
K4SBZ,41,0,41,41,82,0,0,82,0,0,0,32,2,0,0,34,100,100,100,0,0,0,0,0,3088
K4VOZ,14,0,14,9,18,5,5,23,0,0,2,10,0,1,0,13,100,100,100,0,0,0,0,0,599
K4WES,75,0,75,0,0,75,75,75,0,0,0,54,0,0,0,54,100,100,100,0,0,0,0,0,4350
K4YYL,19,0,19,19,38,0,0,38,0,17,0,0,0,0,0,17,100,100,100,50,0,50,0,0,1046
K4ZGB,12,0,12,12,24,0,0,24,0,0,11,1,0,0,0,12,100,100,100,0,0,0,0,0,588
K5CS,25,0,25,25,50,0,0,50,0,2,6,14,0,0,0,22,100,100,100,50,0,0,0,0,1450
K5NA,10,0,10,10,20,0,0,20,10,0,0,0,0,0,0,10,100,100,100,0,0,0,0,0,500
K5NMT,38,0,38,0,0,38,38,38,0,0,1,29,0,0,0,30,100,100,100,50,100,0,0,0,1590
K5PM,34,1,33,4,8,29,29,37,0,0,1,25,0,0,0,26,100,100,100,50,100,100,100,100,1712
K5QR,15,2,13,13,26,0,0,26,0,0,3,7,0,0,0,10,100,100,100,0,0,0,0,0,560
K5VOP,11,0,11,11,22,0,0,22,0,0,2,8,0,0,0,10,100,100,100,50,0,0,0,0,570
K6DGQ,5,1,4,4,8,0,0,8,0,0,0,4,0,0,0,4,100,100,100,0,0,0,0,0,332
K6DLB,14,0,14,0,0,14,14,14,0,0,0,13,0,0,0,13,100,100,100,0,0,0,0,0,482
K6LA,196,1,195,176,352,19,19,371,0,0,1,101,12,0,0,114,100,100,100,50,100,0,0,0,42744
K6QCB,11,1,10,4,8,6,6,14,0,0,0,10,0,0,0,10,100,100,100,0,0,0,0,0,440
K6RB,210,10,200,200,400,0,0,400,0,0,1,1,0,0,0,2,100,100,100,50,100,100,0,0,1350
K6VUG,15,8,7,7,14,0,0,14,0,0,0,6,0,0,0,6,100,100,100,50,0,50,0,0,484
K7AZT,33,16,17,17,34,0,0,34,0,0,7,9,0,0,0,16,100,100,100,50,0,100,0,0,994
K7EFA,23,12,11,5,10,6,6,16,0,0,0,10,0,0,0,10,100,100,100,50,0,50,0,0,560
K7JNA,13,6,7,7,14,0,0,14,0,0,0,7,0,0,0,7,100,100,100,0,0,0,0,0,398
K7NWM,6,3,3,0,0,3,3,3,0,0,0,3,0,0,0,3,100,100,100,50,100,0,0,0,459
K7RBT,6,3,3,3,6,0,0,6,0,0,0,3,0,0,0,3,100,100,100,0,0,0,0,0,318
K7SDW,25,13,12,12,24,0,0,24,0,0,0,12,0,0,0,12,100,100,100,50,0,0,0,0,638
K7ULS,11,5,6,6,12,0,0,12,0,0,6,0,0,0,0,6,100,100,100,0,0,0,0,0,372
K7VIT,80,40,40,40,80,0,0,80,0,0,0,31,0,0,0,31,100,100,100,50,100,50,0,0,2980
K7Y,27,14,13,7,14,6,6,20,0,0,1,11,0,0,0,12,100,100,100,0,0,0,0,0,540
K7YMA,7,3,4,0,0,4,4,4,0,0,0,4,0,0,0,4,100,100,100,50,0,0,0,0,366
K8AG/0,3,2,1,1,2,0,0,2,0,0,1,0,0,0,0,1,100,100,100,50,100,150,0,0,602
K8BTU,62,31,31,31,62,0,0,62,0,5,19,1,0,0,0,25,100,100,100,50,0,0,0,0,1900
K8BZ,31,15,16,16,32,0,0,32,0,0,7,7,0,0,0,14,100,100,100,50,100,0,0,0,898
K8GT,37,19,18,18,36,0,0,36,0,3,4,11,0,0,0,18,100,100,100,50,0,150,0,0,1148
K8LBQ,52,17,35,35,70,0,0,70,0,0,0,24,0,0,0,24,100,100,100,0,0,0,0,0,1980
K8PJK,19,0,19,19,38,0,0,38,0,0,9,8,0,0,0,17,100,100,100,50,0,0,0,0,996
K8RO/3,60,1,59,59,118,0,0,118,0,0,0,39,0,0,0,39,100,100,100,50,100,50,0,0,5102
K8SAS,41,0,41,41,82,0,0,82,0,0,7,28,0,0,0,35,100,100,100,50,100,0,0,0,3320
K8TE,244,2,242,224,448,18,18,466,0,0,9,120,0,0,0,129,100,100,100,0,0,0,0,0,60414
K8UTT,108,0,108,4,8,104,104,112,0,0,42,21,0,0,0,63,100,100,100,0,0,100,0,0,7456
K8YE,65,0,65,65,130,0,0,130,0,0,1,31,0,0,0,32,100,100,100,0,0,0,0,0,4460
K8ZT,23,1,22,22,44,0,0,44,0,0,1,19,0,0,0,20,100,100,100,50,0,0,0,0,1230
K9BGL,437,5,432,383,766,49,49,815,13,11,71,120,2,0,0,217,100,100,100,0,0,0,0,0,177155
K9BTQ,23,2,21,19,38,2,2,40,0,0,3,16,0,0,0,19,100,100,100,0,0,0,0,0,1060
K9JDN,86,71,15,0,0,15,15,15,0,0,1,0,0,0,0,1,100,100,100,0,0,0,0,0,315
K9KEU,103,5,98,98,196,0,0,196,0,3,14,47,0,0,0,64,100,100,100,50,0,350,0,0,13244
K9KM,76,1,75,75,150,0,0,150,0,0,18,33,0,0,0,51,100,100,100,50,100,100,0,0,8200
K9QJS,33,0,33,33,66,0,0,66,0,0,0,2,0,0,0,2,100,100,100,0,0,0,0,0,432
K9VER,31,0,31,31,62,0,0,62,0,0,0,6,0,0,0,6,100,100,100,0,0,0,0,0,672
KA1PPV,19,0,19,19,38,0,0,38,0,0,12,3,0,0,0,15,100,100,100,50,100,0,0,0,1020
KA2BXH,5,0,5,5,10,0,0,10,0,0,0,5,0,0,0,5,100,100,100,0,0,0,0,0,350
KA3MTT,6,0,6,0,0,6,6,6,0,0,1,1,0,0,0,2,100,100,100,0,0,0,0,0,312
KA3SME,6,0,6,0,0,6,6,6,0,0,6,0,0,0,0,6,100,100,100,0,0,50,0,0,386
KA4WJB,33,3,30,30,60,0,0,60,0,0,10,14,0,0,0,24,100,100,100,50,0,0,0,0,1790
KA5TTZ,27,2,25,0,0,25,25,25,0,0,1,21,0,0,0,22,100,100,100,50,100,100,0,0,1100
KA6BID,2,0,2,2,4,0,0,4,0,0,1,1,0,0,0,2,100,100,100,0,0,0,0,0,308
KA9GDW,4,0,4,0,0,4,4,4,0,0,0,0,0,0,0,0,100,100,100,50,0,0,0,0,350
KA9OKH,87,44,43,43,86,0,0,86,0,0,35,0,0,0,0,35,100,100,100,50,0,50,50,0,3460
KB0KFH/K0S,5,2,3,3,6,0,0,6,0,0,0,3,0,0,0,3,100,100,100,0,0,0,0,0,318
KB0LQJ,5,3,2,2,4,0,0,4,0,0,0,2,0,0,0,2,100,100,100,50,0,0,0,0,358
KB0SS,28,14,14,0,0,14,14,14,0,0,0,14,0,0,0,14,100,100,100,0,0,50,0,0,546
KB1BMF,24,12,12,12,24,0,0,24,0,0,4,5,0,0,0,9,100,100,100,50,0,0,0,0,566
KB1BSR,19,9,10,10,20,0,0,20,0,0,8,0,0,0,0,8,100,100,100,50,0,0,0,0,510
KB1HZM,23,2,21,21,42,0,0,42,0,0,14,0,0,0,0,14,100,100,100,0,0,0,0,0,888
KB1IRB,8,0,8,0,0,8,8,8,0,0,0,7,0,0,0,7,100,100,100,50,100,0,0,0,506
KB1WXM,107,0,107,0,0,107,107,107,0,0,0,53,0,0,0,53,100,100,100,50,0,50,0,0,6071
KB2PSI,1,0,1,0,0,1,1,1,0,0,0,1,0,0,0,1,100,100,100,50,0,0,0,0,351
KB3AAY,181,41,140,140,280,0,0,280,0,0,26,41,0,0,0,67,100,100,100,0,0,0,0,0,19060
KB3LIX,54,0,54,53,106,1,1,107,0,0,31,10,0,0,0,41,100,100,100,0,0,100,0,0,4787
KB3ORG,6,0,6,0,0,6,6,6,0,0,1,4,0,0,0,5,100,100,100,50,100,150,0,0,630
KB3SBC,32,0,32,32,64,0,0,64,0,0,8,14,0,0,0,22,100,100,100,50,0,100,0,0,1858
KB4MG,15,0,15,12,24,3,3,27,0,0,0,14,0,0,0,14,100,100,100,50,0,0,0,0,728
KB6IGK,12,0,12,12,24,0,0,24,0,0,0,11,0,0,0,11,100,100,100,0,0,0,0,0,564
KB6NU,100,5,95,95,190,0,0,190,0,0,43,0,0,0,0,43,100,100,100,50,0,50,0,0,8570
KB8GAE,65,0,65,65,130,0,0,130,2,8,27,12,0,0,0,49,100,100,100,50,100,0,0,0,6820
KB8ZGL,231,0,231,0,0,231,231,231,0,0,0,118,0,0,0,118,100,100,100,50,0,0,0,0,27608
KB9EWG,4,0,4,4,8,0,0,8,0,0,0,4,0,0,0,4,100,100,100,0,0,0,0,0,332
KC0BYE,12,0,12,12,24,0,0,24,0,0,0,12,0,0,0,12,100,100,100,50,0,50,0,0,688
KC0P,22,8,14,14,28,0,0,28,0,0,7,0,0,0,0,7,100,100,100,50,100,50,0,0,696
KC1AEO,5,0,5,0,0,5,5,5,0,0,0,3,0,0,0,3,100,100,100,50,0,0,0,0,365
KC1SA,10,0,10,10,20,0,0,20,0,0,1,9,0,0,0,10,100,100,100,0,0,100,0,0,600
KC2JJQ,4,0,4,0,0,4,4,4,0,0,2,1,0,0,0,3,100,100,100,0,0,0,0,0,312
KC2SWB,25,0,25,25,50,0,0,50,0,0,0,22,0,0,0,22,100,100,100,50,100,0,0,0,1550
KC2WUF,11,0,11,11,22,0,0,22,0,1,5,1,0,0,0,7,100,100,100,0,0,0,0,0,454
KC3ASH,4,0,4,0,0,4,4,4,0,0,2,2,0,0,0,4,100,100,100,50,0,0,0,0,366
KC3FDA,10,0,10,10,20,0,0,20,0,0,0,10,0,0,0,10,100,100,100,50,100,0,0,0,650
KC4AUF,50,4,46,46,92,0,0,92,0,0,0,33,0,0,0,33,100,100,100,50,100,50,0,0,3536
KC4GL,46,0,46,0,0,46,46,46,0,0,28,9,0,0,0,37,100,100,100,0,100,100,0,0,2202
KC4SI,2,0,2,2,4,0,0,4,0,0,2,0,0,0,0,2,100,100,100,50,0,0,0,0,358
KC5DCT,16,0,16,8,16,8,8,24,0,0,0,15,0,0,0,15,100,100,100,50,0,0,0,0,710
KC6MIE,12,0,12,0,0,12,12,12,0,0,0,10,0,0,0,10,100,100,100,0,0,0,0,0,420
KC6ZKT,6,0,6,0,0,6,6,6,0,0,0,6,0,0,0,6,100,100,100,50,0,0,0,0,386
KC8RPV,29,0,29,29,58,0,0,58,0,0,11,14,0,0,0,25,100,100,100,0,100,200,0,0,2050
KC9UNL,21,0,21,10,20,11,11,31,0,0,17,0,0,0,0,17,100,100,100,0,0,0,0,0,827
KC9UXC,4,0,4,0,0,4,4,4,0,0,0,0,0,0,0,0,100,100,100,50,0,0,0,0,350
KD0FZT,13,0,13,0,0,13,13,13,0,0,0,11,0,0,0,11,100,100,100,0,0,0,0,0,443
KD0IRW,76,0,76,22,44,54,54,98,0,0,16,45,0,0,0,61,100,100,100,0,0,0,0,0,6278
KD1YV,3,0,3,3,6,0,0,6,0,0,0,3,0,0,0,3,100,100,100,50,0,0,0,0,368
KD2ABK,4,0,4,0,0,4,4,4,0,0,3,1,0,0,0,4,100,100,100,0,0,0,0,0,316
KD2GUD,26,0,26,3,6,23,23,29,0,0,18,3,0,0,0,21,100,100,100,50,0,0,0,0,959
KD2HJZ,93,0,93,9,18,84,84,102,0,0,44,24,0,0,0,68,100,100,100,0,0,100,0,0,7336
KD2HWE,6,0,6,0,0,6,6,6,0,0,2,4,0,0,0,6,100,100,100,50,100,0,0,0,486
KD2MI,29,0,29,29,58,0,0,58,0,0,17,0,0,0,0,17,100,100,100,50,0,50,0,0,1386
KD3TB,20,0,20,20,40,0,0,40,0,2,7,7,0,0,0,16,100,100,100,0,0,0,0,0,940
KD4QIT,19,0,19,19,38,0,0,38,0,0,15,0,0,0,0,15,100,100,100,0,0,50,0,0,920
KD4UYP,4,0,4,0,0,4,4,4,0,0,0,4,0,0,0,4,100,100,100,50,100,50,0,0,516
KD5HIP,30,0,30,30,60,0,0,60,0,0,25,0,0,0,0,25,100,100,100,50,0,0,0,0,1850
KD5ILA,80,0,80,64,128,16,16,144,0,0,28,38,0,0,0,66,100,100,100,0,0,0,0,0,9804
KD5KC,27,0,27,27,54,0,0,54,0,0,0,26,0,0,0,26,100,100,100,0,0,50,0,0,1754
KD8DEU,75,1,74,74,148,0,0,148,0,0,15,34,0,0,0,49,100,100,100,0,0,0,0,0,7552
KD8UPX,7,0,7,0,0,7,7,7,0,0,2,5,0,0,0,7,100,100,100,0,0,0,0,0,349
KD9CLH,37,0,37,37,74,0,0,74,0,0,0,33,0,0,0,33,100,100,100,50,0,0,0,0,2792
KE0HZX,24,0,24,24,48,0,0,48,0,0,0,17,0,0,0,17,100,100,100,50,0,0,0,0,1166
KE0LCS,29,1,28,28,56,0,0,56,0,0,1,22,0,0,0,23,100,100,100,50,0,100,100,0,1838
KE0TT,96,5,91,91,182,0,0,182,0,0,10,39,0,0,0,49,100,100,100,50,0,0,0,0,9268
KE1B,203,0,203,203,406,0,0,406,0,0,0,113,0,0,0,113,100,100,100,0,0,50,0,0,46228
KE4GVO,15,0,15,15,30,0,0,30,0,0,13,1,0,0,0,14,100,100,100,50,0,0,0,0,770
KE8BYM,43,1,42,42,84,0,0,84,0,0,0,18,0,0,1,19,100,100,100,50,0,0,0,0,1946
KF7GGN,24,1,23,23,46,0,0,46,0,0,2,19,0,0,0,21,100,100,100,50,0,0,0,0,1316
KG2DWS,3,0,3,0,0,3,3,3,0,0,0,3,0,0,0,3,100,100,100,0,0,0,0,0,309
KG4GVJ,6,0,6,6,12,0,0,12,0,0,2,4,0,0,0,6,100,100,100,50,100,0,0,0,522
KG4NXT,27,0,27,23,46,4,4,50,0,0,12,10,0,0,0,22,100,100,100,0,0,0,0,0,1400
KG5LRP,295,10,285,17,34,268,268,302,0,0,0,117,0,0,0,117,100,100,100,50,0,0,0,0,35684
KG5THG,37,0,37,37,74,0,0,74,0,0,0,34,0,0,0,34,100,100,100,50,0,0,0,0,2866
KG7DMI,4,0,4,4,8,0,0,8,0,0,0,4,0,0,0,4,100,100,100,0,0,0,0,0,332
KI0F,87,2,85,22,44,63,63,107,0,0,0,53,0,0,0,53,100,100,100,50,0,0,0,0,6021
KI0G,16,0,16,16,32,0,0,32,0,0,9,0,0,0,0,9,100,100,100,0,0,50,0,0,638
KI4CJT,17,0,17,9,18,8,8,26,0,0,8,5,0,0,0,13,100,100,100,0,100,0,0,0,738
KI4FW,25,2,23,23,46,0,0,46,0,0,0,20,1,0,0,21,100,100,100,50,0,100,0,0,1416
KI4JVE,38,8,30,0,0,30,30,30,0,0,8,18,0,0,0,26,100,100,100,50,100,100,0,50,1380
KI4MZC,40,0,40,40,80,0,0,80,0,4,17,13,0,0,0,34,100,100,100,50,100,150,0,0,3320
KI5SC,11,0,11,0,0,11,11,11,0,0,0,0,0,0,0,0,100,100,100,0,100,0,0,0,400
KJ4AOM,40,0,40,40,80,0,0,80,0,0,11,19,1,0,0,31,100,100,100,0,0,0,0,0,2780
KJ4TOZ,47,0,47,47,94,0,0,94,0,0,29,0,0,0,0,29,100,100,100,0,0,0,0,0,3026
KJ6BQM,14,0,14,14,28,0,0,28,0,0,0,13,0,0,0,13,100,100,100,0,0,50,0,0,714
KJ6JZU,31,0,31,0,0,31,31,31,0,0,0,25,0,0,0,25,100,100,100,0,0,0,0,0,1075
KJ6KCG,16,0,16,0,0,16,16,16,0,0,0,14,0,0,0,14,100,100,100,50,100,0,0,0,674
KJ9C,132,0,132,132,264,0,0,264,0,5,24,65,0,0,0,94,100,100,100,50,0,150,300,0,25616
KK1VT,3,0,3,0,0,3,3,3,0,0,2,1,0,0,0,3,100,100,100,0,0,0,0,0,309
KK3Q,25,0,25,25,50,0,0,50,0,0,12,7,3,0,0,22,100,100,100,50,100,0,0,0,1550
KK4AGN,48,1,47,0,0,47,47,47,0,0,4,34,0,0,0,38,100,100,100,0,0,0,0,0,2086
KK4BZ,36,0,36,0,0,36,36,36,0,0,15,7,0,0,0,22,100,100,100,50,100,0,0,0,1242
KK4MWC,1,0,1,0,0,1,1,1,0,0,0,1,0,0,0,1,100,100,100,50,0,0,0,0,351
KK4TSS,28,0,28,28,56,0,0,56,0,1,17,6,0,0,0,24,100,100,100,50,0,0,0,0,1694
KK5HT,44,1,43,43,86,0,0,86,0,0,0,31,0,0,0,31,100,100,100,0,0,0,0,0,2966
KK6L,12,2,10,10,20,0,0,20,0,0,1,9,0,0,0,10,100,100,100,50,0,50,0,0,600
KK6MLY,9,0,9,0,0,9,9,9,0,0,0,8,0,0,0,8,100,100,100,50,0,150,0,0,572
KM1G,7,0,7,7,14,0,0,14,0,0,2,3,2,0,0,7,100,100,100,0,0,0,0,0,398
KM4FLU,21,0,21,7,14,14,14,28,0,0,0,17,0,0,0,17,100,100,100,0,0,0,0,0,776
KM4HI,110,0,110,7,14,103,103,117,0,0,0,66,3,0,3,72,100,100,100,50,0,0,0,0,8774
KM4OZH,6,0,6,0,0,6,6,6,0,0,4,2,0,0,0,6,100,100,100,50,0,100,0,0,486
KM4RKT,19,0,19,0,0,19,19,19,0,0,14,0,0,0,0,14,100,100,100,0,0,0,0,0,566
KM4VCF,14,0,14,0,0,14,14,14,0,0,5,9,0,0,0,14,100,100,100,0,0,0,0,0,496
KM4VCO,17,0,17,0,0,17,17,17,0,0,9,4,0,0,0,13,100,100,100,50,100,200,100,100,1071
KM4YMI,32,0,32,32,64,0,0,64,0,0,15,10,0,0,0,25,100,100,100,50,0,0,0,0,1950
KN4FRG,130,1,129,0,0,129,129,129,0,0,53,34,1,0,0,88,100,100,100,0,0,150,0,0,11802
KN4Y,15,0,15,15,30,0,0,30,0,0,0,0,0,12,0,12,100,100,100,0,0,0,0,0,660
KP3LH,46,0,46,41,82,5,5,87,0,0,0,31,0,3,0,34,100,100,100,0,0,200,0,0,3458
KP4RP,10,0,10,10,20,0,0,20,0,0,0,0,0,0,0,0,100,100,100,0,0,50,50,0,400
KR7RK,11,0,11,11,22,0,0,22,0,0,2,3,0,3,0,8,100,100,100,50,0,0,0,0,526
KS0M,19,1,18,18,36,0,0,36,0,0,0,12,0,0,0,12,100,100,100,0,0,0,0,0,732
KS3K,35,0,35,34,68,1,1,69,0,0,0,26,0,0,0,26,100,100,100,0,0,0,0,0,2094
KS3O,45,6,39,36,72,3,3,75,0,0,16,16,0,0,0,32,100,100,100,50,0,100,0,0,2850
KS4S,39,0,39,39,78,0,0,78,0,0,29,0,0,0,0,29,100,100,100,0,0,0,0,0,2562
KS6M,19,0,19,19,38,0,0,38,0,0,0,12,0,0,0,12,100,100,100,0,0,0,0,0,756
KS7T,205,0,205,186,372,19,19,391,0,0,3,116,0,0,0,119,100,100,100,0,100,0,0,0,46929
KT3L,56,1,55,55,110,0,0,110,0,2,30,6,0,0,0,38,100,100,100,50,0,0,0,0,4530
KT3P,9,0,9,9,18,0,0,18,0,0,6,1,0,0,0,7,100,100,100,0,0,0,0,0,426
KT4BOB,4,0,4,0,0,4,4,4,0,0,3,1,0,0,0,4,100,100,100,0,0,0,0,0,316
KT4Q,188,3,185,70,140,115,115,255,0,0,4,93,0,0,0,97,100,100,100,0,0,100,0,0,25135
KT5LA,20,0,20,20,40,0,0,40,0,0,0,16,0,0,0,16,100,100,100,50,0,0,0,0,990
KT8TD,8,0,8,0,0,8,8,8,0,0,0,6,2,0,0,8,100,100,100,0,0,0,0,0,364
KU1N,41,0,41,41,82,0,0,82,0,4,7,23,0,0,0,34,100,100,100,0,0,0,0,0,3088
KU4V,69,0,69,69,138,0,0,138,0,0,8,37,1,0,0,46,100,100,100,50,0,0,0,0,6698
KW0J,97,0,97,97,194,0,0,194,0,0,31,40,4,0,0,75,100,100,100,50,100,0,0,0,15000
KW0KW,1,0,1,0,0,1,1,1,0,0,1,0,0,0,0,1,100,100,100,50,100,0,0,0,451
KW1NG,23,0,23,23,46,0,0,46,0,0,10,11,0,0,0,21,100,100,100,50,100,0,0,0,1416
KW9R,72,0,72,72,144,0,0,144,0,0,45,0,0,0,0,45,100,100,100,50,0,0,0,0,6830
KX4KU,17,1,16,16,32,0,0,32,0,0,13,1,0,0,0,14,100,100,100,50,0,0,0,0,798
KY4L,56,5,51,40,80,11,11,91,0,0,27,16,0,0,0,43,100,100,100,50,0,0,0,0,4263
LELAND,28,23,5,5,10,0,0,10,0,0,0,1,0,0,0,1,100,100,100,0,0,0,0,0,310
LU5FF,29,0,29,29,58,0,0,58,0,0,0,24,1,0,0,25,100,100,100,0,100,100,100,0,2050
N0AXZ,22,0,22,22,44,0,0,44,0,0,0,18,0,0,0,18,100,100,100,0,0,0,0,0,1092
N0BUI,71,0,71,71,142,0,0,142,0,0,17,35,0,0,0,52,100,100,100,0,0,0,0,0,7684
N0DIM,7,0,7,0,0,7,7,7,0,0,0,7,0,0,0,7,100,100,100,50,0,0,0,0,399
N0GB,52,3,49,49,98,0,0,98,0,0,17,21,0,0,0,38,100,100,100,0,0,100,0,0,4124
N0GOS,35,0,35,35,70,0,0,70,0,0,0,20,0,0,0,20,100,100,100,0,0,0,0,0,1700
N0KQ,50,0,50,50,100,0,0,100,0,0,0,44,1,0,0,45,100,100,100,0,0,50,0,0,4850
N0NM,117,0,117,117,234,0,0,234,0,0,0,83,0,0,0,83,100,100,100,0,0,0,0,0,19722
N0UK,58,0,58,58,116,0,0,116,0,0,0,39,0,0,0,39,100,100,100,50,100,50,0,0,5024
N0UV,129,3,126,126,252,0,0,252,0,0,0,44,0,0,0,44,100,100,100,0,0,0,0,0,11388
N1COR,15,1,14,0,0,14,14,14,0,0,0,12,0,0,0,12,100,100,100,50,0,0,0,0,518
N1DC,102,27,75,75,150,0,0,150,0,7,10,42,0,0,0,59,100,100,100,0,0,0,0,0,9150
N1FI,8,0,8,0,0,8,8,8,0,0,0,8,0,0,0,8,100,100,100,50,0,0,0,0,414
N1FTP,21,0,21,0,0,21,21,21,0,0,7,11,0,0,0,18,100,100,100,50,0,100,0,0,828
N1IA,16,0,16,16,32,0,0,32,0,0,0,13,0,0,0,13,100,100,100,0,0,0,0,0,716
N1IXF,116,12,104,104,208,0,0,208,0,0,1,42,0,0,0,43,100,100,100,50,0,0,0,0,9294
N1MD,72,0,72,72,144,0,0,144,0,0,0,42,0,0,0,42,100,100,100,50,0,0,0,0,6398
N1NN,13,1,12,12,24,0,0,24,0,0,1,11,0,0,0,12,100,100,100,0,0,0,0,0,588
N1SER,2,0,2,0,0,2,2,2,0,0,0,2,0,0,0,2,100,100,100,0,0,0,0,0,304
N2CG,31,0,31,31,62,0,0,62,0,0,0,25,0,0,0,25,100,100,100,50,0,50,0,0,1950
N2ESP,31,0,31,31,62,0,0,62,0,0,2,26,0,0,0,28,100,100,100,50,0,0,0,0,2086
N2FYE,15,0,15,15,30,0,0,30,0,0,0,1,0,0,0,1,100,100,100,0,100,0,0,0,430
N2GZ,7,0,7,0,0,7,7,7,0,0,4,3,0,0,0,7,100,100,100,50,0,0,0,0,399
N2HTT,9,0,9,9,18,0,0,18,0,1,4,4,0,0,0,9,100,100,100,0,0,0,0,0,462
N2KND,7,0,7,7,14,0,0,14,0,0,0,6,0,0,0,6,100,100,100,50,100,250,0,0,784
N3AO,38,0,38,38,76,0,0,76,0,0,17,12,0,0,0,29,100,100,100,0,0,0,0,0,2504
N3ATE,4,0,4,2,4,2,2,6,0,0,4,0,0,0,0,4,100,100,100,50,0,0,0,0,374
N3FWE,13,0,13,4,8,9,9,17,0,0,11,2,0,0,0,13,100,100,100,0,0,0,0,0,521
N3HEE,128,0,128,128,256,0,0,256,0,1,46,32,1,0,0,80,100,100,100,0,0,0,0,0,20780
N3KN,67,0,67,67,134,0,0,134,0,3,30,16,0,0,0,49,100,100,100,0,0,0,0,0,6866
N3MLB,22,0,22,22,44,0,0,44,0,1,6,12,0,0,0,19,100,100,100,50,0,150,0,0,1336
N3SW,40,0,40,40,80,0,0,80,0,5,14,17,0,0,0,36,100,100,100,50,0,0,0,0,3230
N3TWM,25,0,25,24,48,1,1,49,0,0,9,10,0,0,0,19,100,100,100,50,100,0,0,0,1381
N4BAT,21,0,21,5,10,16,16,26,0,0,0,18,0,0,0,18,100,100,100,50,0,0,0,0,818
N4BP,444,17,427,427,854,0,0,854,0,0,0,167,0,0,0,167,100,100,100,0,0,0,0,0,142918
N4BTA,47,0,47,47,94,0,0,94,0,0,21,13,0,0,0,34,100,100,100,50,100,100,0,0,3746
N4DLT,14,0,14,14,28,0,0,28,0,0,0,10,0,0,0,10,100,100,100,50,0,0,0,0,630
N4E,8,0,8,0,0,8,8,8,0,0,8,0,0,0,0,8,100,100,100,0,0,0,0,0,364
N4HAI,55,0,55,55,110,0,0,110,0,0,26,11,0,0,0,37,100,100,100,50,100,0,0,0,4520
N4NM,42,0,42,42,84,0,0,84,0,0,11,24,0,0,0,35,100,100,100,0,0,0,0,0,3240
N4NO,161,1,160,160,320,0,0,320,8,22,62,0,0,0,0,92,100,100,100,50,0,150,0,0,29940
N4QM,75,0,75,75,150,0,0,150,0,0,38,0,0,0,0,38,100,100,100,50,0,50,0,0,6100
N4QS,146,0,146,144,288,2,2,290,0,20,20,75,1,0,0,116,100,100,100,0,0,0,0,0,33940
N4RDZ,1,0,1,0,0,1,1,1,0,1,0,0,0,0,0,1,100,100,100,50,0,0,0,0,351
N4VUG,10,0,10,10,20,0,0,20,0,0,0,9,0,0,0,9,100,100,100,0,0,0,0,0,480
N4YDU,225,0,225,173,346,52,52,398,0,9,52,70,3,0,0,134,100,100,100,0,0,0,0,0,53632
N5EE,122,0,122,122,244,0,0,244,0,1,19,70,0,0,0,90,100,100,100,50,0,150,0,0,22460
N5EKW,9,0,9,9,18,0,0,18,0,0,0,9,0,0,0,9,100,100,100,50,0,0,0,0,512
N5RB,80,0,80,80,160,0,0,160,0,0,9,52,2,0,0,63,100,100,100,50,0,200,0,0,10630
N5RHS,5,0,5,0,0,5,5,5,0,0,0,5,0,0,0,5,100,100,100,50,100,0,0,0,475
N5ZC,254,0,254,136,272,118,118,390,0,0,0,134,0,0,0,134,100,100,100,50,0,0,0,0,52610
N5ZO,136,0,136,136,272,0,0,272,0,0,0,94,2,0,0,96,100,100,100,0,0,0,0,0,26412
N5ZY,37,0,37,34,68,3,3,71,0,2,11,22,0,0,0,35,100,100,100,50,0,150,0,0,2985
N6BCT,7,0,7,3,6,4,4,10,0,0,0,7,0,0,0,7,100,100,100,50,100,0,0,0,520
N6GP,11,0,11,11,22,0,0,22,0,0,0,11,0,0,0,11,100,100,100,0,0,0,0,0,542
N6IC,18,0,18,18,36,0,0,36,0,0,0,17,0,0,0,17,100,100,100,0,0,0,0,0,912
N6KL,15,1,14,14,28,0,0,28,0,0,0,12,0,0,0,12,100,100,100,50,100,50,0,0,836
N6MRS,1,0,1,0,0,1,1,1,0,0,0,1,0,0,0,1,100,100,100,0,0,0,0,0,301
N6OI,28,0,28,28,56,0,0,56,0,0,0,18,0,0,0,18,100,100,100,50,0,50,0,0,1408
N6REK,7,0,7,3,6,4,4,10,0,0,2,5,0,0,0,7,100,100,100,0,0,0,0,0,370
N7EIE,25,0,25,25,50,0,0,50,0,3,2,18,0,0,0,23,100,100,100,50,0,150,0,0,1650
N7GOA,62,1,61,61,122,0,0,122,0,0,6,36,0,0,0,42,100,100,100,50,100,0,0,0,5574
N7MSI,5,0,5,0,0,5,5,5,0,0,0,5,0,0,0,5,100,100,100,50,0,0,0,0,375
N7RCS,12,0,12,12,24,0,0,24,0,0,8,2,0,0,0,10,100,100,100,0,0,200,0,0,740
N7S,115,0,115,115,230,0,0,230,0,0,13,72,1,0,0,86,100,100,100,0,0,0,0,0,20080
N7TWS,25,16,9,9,18,0,0,18,0,0,0,1,0,0,0,1,100,100,100,50,0,50,0,0,418
N7WY,101,0,101,81,162,20,20,182,0,0,5,56,0,0,0,61,100,100,100,50,0,0,0,0,11452
N8BD,9,0,9,0,0,9,9,9,0,0,7,1,0,0,0,8,100,100,100,50,0,0,0,0,422
N8FYL,32,0,32,32,64,0,0,64,0,0,17,12,0,0,0,29,100,100,100,0,0,0,0,0,2156
N8HM,17,0,17,17,34,0,0,34,0,0,0,12,0,0,0,12,100,100,100,0,0,50,0,0,758
N8KR,60,0,60,60,120,0,0,120,0,0,21,14,0,0,0,35,100,100,100,50,0,0,0,0,4550
N8NFE,18,0,18,0,0,18,18,18,0,1,10,5,0,0,0,16,100,100,100,50,0,0,0,0,638
N8PW,397,3,394,394,788,0,0,788,0,0,113,0,0,0,0,113,100,100,100,50,0,50,0,0,89444
N8SK,11,0,11,10,20,1,1,21,0,0,0,9,0,0,0,9,100,100,100,50,0,0,0,0,539
N8SOP,5,0,5,5,10,0,0,10,0,0,3,2,0,0,0,5,100,100,100,50,100,100,0,0,600
N8TCP,19,0,19,19,38,0,0,38,0,0,3,14,0,0,0,17,100,100,100,0,0,0,0,0,946
N8TFD,6,0,6,6,12,0,0,12,0,1,5,0,0,0,0,6,100,100,100,0,0,0,0,0,372
N8VQG,7,0,7,0,0,7,7,7,0,0,3,4,0,0,0,7,100,100,100,0,0,0,0,0,349
N8YRF,2,0,2,1,2,1,1,3,0,0,2,0,0,0,0,2,100,100,100,50,0,0,0,0,356
N9BD,9,0,9,0,0,9,9,9,0,0,0,9,0,0,0,9,100,100,100,50,0,50,0,50,531
N9EP,97,0,97,90,180,7,7,187,4,2,31,31,0,0,0,68,100,100,100,50,100,200,450,0,13816
N9JF,53,0,53,48,96,5,5,101,0,0,12,27,0,0,0,39,100,100,100,50,0,0,0,0,4289
N9US,7,0,7,7,14,0,0,14,0,0,5,2,0,0,0,7,100,100,100,50,0,0,0,0,448
N9WL,8,0,8,0,0,8,8,8,0,0,0,8,0,0,0,8,100,100,100,50,100,50,0,0,564
NA2X,22,5,17,17,34,0,0,34,0,11,0,0,0,0,0,11,100,100,100,50,0,0,0,0,724
NA6SA,16,0,16,16,32,0,0,32,2,0,2,12,0,0,0,16,100,100,100,50,100,0,0,0,962
NB0Z,26,1,25,25,50,0,0,50,0,0,1,20,0,0,0,21,100,100,100,0,0,0,0,0,1350
NC4MI,38,0,38,13,26,25,25,51,0,0,6,26,0,0,0,32,100,100,100,0,0,200,0,0,2132
NC4RT,11,0,11,11,22,0,0,22,0,0,4,7,0,0,0,11,100,100,100,50,0,150,0,0,742
NC6Q,19,0,19,19,38,0,0,38,0,0,5,11,0,0,0,16,100,100,100,0,0,0,0,0,908
ND4G,18,0,18,14,28,4,4,32,0,0,1,14,0,0,0,15,100,100,100,0,0,0,0,0,780
ND9Z,68,0,68,68,136,0,0,136,0,0,0,36,0,0,0,36,100,100,100,50,0,50,0,0,5296
NE5DL,70,0,70,70,140,0,0,140,0,0,16,40,0,0,0,56,100,100,100,50,0,0,0,0,8190
NF8M,61,0,61,61,122,0,0,122,3,10,17,16,0,0,0,46,100,100,100,50,0,300,0,0,6262
NG2H,116,0,116,116,232,0,0,232,3,12,34,37,2,0,0,88,100,100,100,50,0,0,0,0,20766
NG9M,90,0,90,0,0,90,90,90,0,13,42,9,0,0,0,64,100,100,100,50,0,150,0,0,6260
NJ0P,7,0,7,7,14,0,0,14,0,0,0,6,0,0,0,6,100,100,100,50,0,0,0,0,434
NK6A,81,0,81,81,162,0,0,162,0,0,7,56,1,0,0,64,100,100,100,0,0,0,0,0,10668
NN5O,52,0,52,52,104,0,0,104,0,0,0,40,0,0,0,40,100,100,100,50,0,50,0,0,4560
NO7DE,10,0,10,10,20,0,0,20,0,0,0,10,0,0,0,10,100,100,100,50,0,50,0,0,600
NO7E,17,1,16,16,32,0,0,32,0,0,1,15,0,0,0,16,100,100,100,50,0,0,0,0,862
NP4EG,20,0,20,20,40,0,0,40,0,0,0,20,0,0,0,20,100,100,100,0,0,0,0,0,1100
NP4LW,5,1,4,0,0,4,4,4,0,0,0,4,0,0,0,4,100,100,100,0,0,0,0,0,316
NP4RA,15,1,14,14,28,0,0,28,0,0,0,11,0,0,0,11,100,100,100,0,0,0,0,0,608
NQ6N,116,3,113,113,226,0,0,226,0,35,0,43,0,0,0,78,100,100,100,50,0,100,0,0,18078
NQ9A,13,0,13,12,24,1,1,25,0,0,2,10,0,0,0,12,100,100,100,0,0,0,0,0,600
NR4J,14,0,14,14,28,0,0,28,0,0,13,0,0,0,0,13,100,100,100,50,100,50,0,0,864
NS3C,44,0,44,44,88,0,0,88,0,0,3,25,0,0,0,28,100,100,100,50,0,0,0,0,2814
NV1W,11,0,11,11,22,0,0,22,0,0,0,10,0,0,0,10,100,100,100,0,0,50,0,0,570
OM5UM,4,0,4,4,8,0,0,8,0,0,0,3,0,0,0,3,100,100,100,0,100,0,0,0,424
SP9JPA,2,0,2,2,4,0,0,4,0,0,0,2,0,0,0,2,100,100,100,50,0,0,0,0,358
SV1QFV,41,0,41,41,82,0,0,82,0,0,0,29,0,0,0,29,100,100,100,0,0,0,0,0,2678
SV1RVP,23,0,23,21,42,2,2,44,0,0,0,20,0,0,0,20,100,100,100,0,0,50,0,0,1230
SV8CYR,33,0,33,31,62,2,2,64,0,0,0,1,0,0,0,1,100,100,100,50,0,0,0,0,414
SV8CYV,1,0,1,1,2,0,0,2,0,0,0,1,0,0,0,1,100,100,100,50,0,0,0,0,352
SV8GXQ,25,0,25,25,50,0,0,50,0,0,2,1,0,0,0,3,100,100,100,0,0,0,0,0,450
TG0AA,12,0,12,12,24,0,0,24,0,0,0,10,0,0,0,10,100,100,100,0,0,0,0,0,540
VA2KT,9,0,9,9,18,0,0,18,0,0,6,1,0,0,0,7,100,100,100,0,0,100,0,0,526
VA3EC,8,0,8,8,16,0,0,16,0,0,0,6,1,0,0,7,100,100,100,0,0,0,0,0,412
VA5LD,14,0,14,14,28,0,0,28,0,0,0,12,0,0,0,12,100,100,100,50,0,0,0,0,686
VA7NLF,11,0,11,0,0,11,11,11,0,0,4,6,0,0,0,10,100,100,100,0,0,0,0,0,410
VE2GT,5,0,5,0,0,5,5,5,0,0,0,5,0,0,0,5,100,100,100,50,0,0,0,0,375
VE3CV,42,0,42,42,84,0,0,84,6,17,0,9,0,0,0,32,100,100,100,0,100,0,0,0,3088
VE3CWU,30,0,30,30,60,0,0,60,0,0,0,24,0,0,0,24,100,100,100,0,0,0,0,0,1740
VE3EAL,4,0,4,0,0,4,4,4,0,0,4,0,0,0,0,4,100,100,100,0,0,0,0,0,316
VE3HED,20,0,20,20,40,0,0,40,0,0,10,9,0,0,0,19,100,100,100,0,0,0,0,0,1060
VE3KP,159,1,158,158,316,0,0,316,0,0,53,0,0,0,0,53,100,100,100,0,0,0,0,0,17048
VE3MGY,122,0,122,122,244,0,0,244,8,17,37,10,0,0,0,72,100,100,100,50,0,200,0,0,18118
VE3OSZ,31,0,31,31,62,0,0,62,0,0,14,4,0,0,0,18,100,100,100,0,0,0,0,0,1416
VE3PVI,61,0,61,61,122,0,0,122,0,0,17,33,0,0,0,50,100,100,100,0,0,0,0,0,6400
VE3UTT,41,0,41,41,82,0,0,82,0,0,5,30,1,0,0,36,100,100,100,0,0,150,0,0,3402
VE3VPT,13,0,13,13,26,0,0,26,0,0,0,12,0,0,0,12,100,100,100,0,0,0,0,0,612
VE7CA,44,3,41,41,82,0,0,82,0,4,16,13,1,0,0,34,100,100,100,0,0,0,0,0,3088
VE7IO,78,38,40,40,80,0,0,80,0,0,0,37,0,0,0,37,100,100,100,0,0,50,0,0,3310
VE7NZ,1,1,0,0,0,0,0,0,0,0,0,0,0,0,0,0,100,100,100,50,0,0,0,0,350
VE9TFB,2,1,1,1,2,0,0,2,0,0,0,1,0,0,0,1,100,100,100,0,0,0,0,0,302
VU2IT,30,14,16,16,32,0,0,32,0,0,2,14,0,0,0,16,100,100,100,0,0,0,0,0,812
W0C,154,3,151,151,302,0,0,302,0,0,43,41,0,0,0,84,100,100,100,0,0,0,0,0,25668
W0D,378,0,378,352,704,26,26,730,0,0,13,140,0,0,0,153,100,100,100,50,100,100,0,0,112240
W0ECC,461,21,440,391,782,49,49,831,0,0,92,107,13,0,0,212,100,100,100,0,0,0,0,0,176472
W0FL,112,0,112,109,218,3,3,221,0,0,25,35,0,0,0,60,100,100,100,0,0,0,0,0,13560
W0GXA,26,0,26,26,52,0,0,52,0,0,0,20,3,0,0,23,100,100,100,0,0,0,0,0,1496
W0IS,3,0,3,3,6,0,0,6,0,0,3,0,0,0,0,3,100,100,100,50,0,0,0,0,368
W0JJR,3,0,3,0,0,3,3,3,1,0,0,2,0,0,0,3,100,100,100,50,0,0,0,0,359
W0JTC,26,0,26,0,0,26,26,26,0,0,0,20,0,0,0,20,100,100,100,0,0,0,0,0,820
W0LGU,22,0,22,22,44,0,0,44,0,0,13,4,0,0,0,17,100,100,100,50,0,0,0,0,1098
W0PWE,8,0,8,8,16,0,0,16,0,0,7,0,0,0,0,7,100,100,100,50,0,0,0,0,462
W1ANT,22,0,22,22,44,0,0,44,0,0,1,17,0,0,0,18,100,100,100,0,100,0,0,0,1192
W1DGL,6,0,6,4,8,2,2,10,0,0,0,5,0,0,0,5,100,100,100,50,100,0,0,0,500
W1HP,22,0,22,21,42,1,1,43,0,0,15,1,0,0,0,16,100,100,100,0,0,0,0,0,988
W1HS,126,1,125,58,116,67,67,183,0,0,32,48,0,0,0,80,100,100,100,0,0,0,0,0,14940
W1LEM,20,0,20,10,20,10,10,30,0,0,6,14,0,0,0,20,100,100,100,0,0,0,0,0,900
W1MJ,37,0,37,37,74,0,0,74,0,0,12,11,0,0,0,23,100,100,100,0,100,100,0,0,2202
W1QK,56,0,56,56,112,0,0,112,1,1,13,35,1,0,0,51,100,100,100,50,0,0,0,0,6062
W1SJ,479,4,475,312,624,163,163,787,0,5,57,166,0,0,0,228,100,100,100,50,100,150,0,0,180036
W1TO,65,0,65,65,130,0,0,130,0,0,8,42,0,0,0,50,100,100,100,0,0,0,0,0,6800
W1TOD,16,0,16,0,0,16,16,16,0,0,8,7,0,0,0,15,100,100,100,50,0,0,0,0,590
W1UJ,349,3,346,346,692,0,0,692,0,0,30,134,6,1,0,171,100,100,100,50,0,0,0,0,118682
W1ZT,21,0,21,21,42,0,0,42,0,0,8,13,0,0,0,21,100,100,100,50,0,50,0,0,1282
W2DPT,15,0,15,15,30,0,0,30,1,3,9,0,0,0,0,13,100,100,100,50,0,0,0,0,740
W2HTI,19,0,19,0,0,19,19,19,0,0,0,16,0,0,0,16,100,100,100,0,0,0,0,0,604
W2KGY,20,0,20,0,0,20,20,20,0,0,17,1,0,0,0,18,100,100,100,0,0,0,0,0,660
W2NP,10,1,9,9,18,0,0,18,0,0,0,8,0,0,0,8,100,100,100,50,0,0,0,0,494
W2NPT,63,0,63,59,118,4,4,122,0,0,9,27,2,0,0,38,100,100,100,50,0,0,0,0,4986
W2SFD,63,0,63,63,126,0,0,126,0,0,0,29,0,0,0,29,100,100,100,0,0,0,0,0,3954
W2UDT,11,0,11,11,22,0,0,22,0,0,3,8,0,0,0,11,100,100,100,50,0,100,0,0,692
W3CB,26,0,26,26,52,0,0,52,0,0,22,0,0,0,0,22,100,100,100,50,0,50,0,0,1544
W3DET,21,0,21,21,42,0,0,42,0,0,0,20,0,0,0,20,100,100,100,50,0,0,0,0,1190
W3HMK/P,35,0,35,0,0,35,35,35,0,0,17,6,0,0,0,23,100,100,100,50,0,100,0,0,1255
W3IUU,103,0,103,101,202,2,2,204,0,21,23,25,3,1,0,73,100,100,100,0,0,0,0,0,15192
W3KWH,9,0,9,0,0,9,9,9,0,0,7,2,0,0,0,9,100,100,100,0,0,0,0,0,381
W3PR,17,0,17,17,34,0,0,34,0,0,8,8,0,0,0,16,100,100,100,50,0,0,0,0,894
W3RL,4,0,4,4,8,0,0,8,0,0,4,0,0,0,0,4,100,100,100,50,0,50,0,0,432
W3RLO,8,0,8,8,16,0,0,16,0,0,0,8,0,0,0,8,100,100,100,0,100,0,0,0,528
W3UL,50,25,25,19,38,6,6,44,0,0,16,2,0,0,0,18,100,100,100,50,0,0,0,0,1142
W3ZIC,25,0,25,0,0,25,25,25,0,0,19,3,0,0,0,22,100,100,100,0,0,0,0,0,850
W4AU,16,0,16,16,32,0,0,32,0,0,5,9,0,0,0,14,100,100,100,0,0,0,0,0,748
W4BKM,25,0,25,0,0,25,25,25,0,0,1,18,0,0,0,19,100,100,100,0,0,0,0,0,775
W4CHI,60,0,60,57,114,3,3,117,0,1,26,17,5,2,0,51,100,100,100,50,0,0,0,0,6317
W4DFG,36,0,36,29,58,7,7,65,0,13,10,6,4,0,0,33,100,100,100,0,0,200,0,0,2645
W4E,150,1,149,34,68,115,115,183,0,0,40,41,0,0,0,81,100,100,100,0,0,0,0,0,15123
W4FEB,7,0,7,0,0,7,7,7,0,0,3,4,0,0,0,7,100,100,100,50,0,0,0,0,399
W4GHV,12,0,12,12,24,0,0,24,0,0,0,10,0,0,0,10,100,100,100,50,0,0,0,0,590
W4HS,180,24,156,20,40,136,136,176,0,0,0,97,0,0,0,97,100,100,100,0,0,50,0,0,17422
W4JL,120,2,118,50,100,68,68,168,0,0,45,34,0,0,0,79,100,100,100,0,0,0,0,0,13572
W4JTP,80,0,80,78,156,2,2,158,0,0,27,33,4,0,0,64,100,100,100,50,0,0,0,0,10462
W4LID,25,0,25,0,0,25,25,25,0,0,13,12,0,0,0,25,100,100,100,0,0,0,0,0,925
W4MDV,12,0,12,11,22,1,1,23,0,0,0,12,0,0,0,12,100,100,100,50,0,0,0,0,626
W4PF,21,0,21,17,34,4,4,38,0,0,0,21,0,0,0,21,100,100,100,0,0,50,0,0,1148
W4TMW,21,0,21,21,42,0,0,42,0,12,0,8,0,0,0,20,100,100,100,50,0,0,0,0,1190
W4TTM,90,0,90,90,180,0,0,180,0,0,27,39,0,0,0,66,100,100,100,0,0,0,0,0,12180
W5AC,150,0,150,0,0,150,150,150,0,0,0,80,0,0,0,80,100,100,100,50,0,0,0,0,12350
W5FMH,200,4,196,196,392,0,0,392,0,0,25,88,19,1,0,133,100,100,100,0,0,0,0,0,52436
W5GAD,301,0,301,256,512,45,45,557,0,0,18,147,1,0,0,166,100,100,100,50,0,0,0,0,92812
W5JVR,34,1,33,33,66,0,0,66,0,0,8,16,0,0,0,24,100,100,100,50,0,0,0,0,1934
W5MMW/VE3,55,0,55,55,110,0,0,110,0,0,0,33,0,0,0,33,100,100,100,50,100,0,0,0,4080
W5QLF,26,0,26,25,50,1,1,51,0,0,0,24,0,0,0,24,100,100,100,0,0,50,0,0,1574
W5QZ,20,0,20,0,0,20,20,20,0,0,0,17,0,0,0,17,100,100,100,50,0,50,0,0,740
W5RE,19,1,18,18,36,0,0,36,1,6,6,4,0,0,0,17,100,100,100,50,0,0,0,0,962
W5RRR,12,0,12,12,24,0,0,24,0,0,7,5,0,0,0,12,100,100,100,50,100,100,0,0,838
W5TA,218,1,217,217,434,0,0,434,0,0,8,113,0,0,0,121,100,100,100,50,0,0,0,0,52864
W6DEI,49,0,49,49,98,0,0,98,0,0,0,31,0,0,0,31,100,100,100,0,0,50,50,0,3438
W6IHG,18,0,18,18,36,0,0,36,0,0,0,14,0,0,0,14,100,100,100,50,0,50,0,0,904
W6JTI,64,0,64,64,128,0,0,128,0,6,6,38,0,0,0,50,100,100,100,0,0,0,0,0,6700
W6JWP,1,0,1,0,0,1,1,1,0,0,1,0,0,0,0,1,100,100,100,0,0,0,0,0,301
W6K,41,0,41,41,82,0,0,82,0,0,6,27,0,0,0,33,100,100,100,0,0,0,0,0,3006
W6KRF,3,0,3,0,0,3,3,3,0,0,2,1,0,0,0,3,100,100,100,50,0,0,0,0,359
W6MRR,30,2,28,28,56,0,0,56,0,0,0,19,0,0,0,19,100,100,100,50,100,150,0,250,1914
W6MVM,22,0,22,22,44,0,0,44,0,0,0,19,0,0,0,19,100,100,100,50,0,0,0,0,1186
W6RDF,360,0,360,272,544,88,88,632,0,0,5,157,8,0,0,170,100,100,100,50,0,150,0,0,107940
W6S,209,0,209,160,320,49,49,369,1,7,40,83,4,0,0,135,100,100,100,0,0,0,0,0,50115
W6SFI,21,0,21,18,36,3,3,39,0,0,0,21,0,0,0,21,100,100,100,0,0,0,0,0,1119
W6SX,275,0,275,275,550,0,0,550,0,0,28,97,0,0,0,125,100,100,100,50,0,0,0,0,69100
W6SZN,28,0,28,28,56,0,0,56,0,0,10,17,0,0,0,27,100,100,100,0,0,0,0,0,1812
W6YX,217,0,217,217,434,0,0,434,0,0,22,114,8,0,0,144,100,100,100,0,0,150,0,0,62946
W7AUM,80,0,80,0,0,80,80,80,0,0,0,68,0,0,0,68,100,100,100,0,0,0,0,0,5740
W7BV,39,0,39,39,78,0,0,78,0,0,3,30,0,0,0,33,100,100,100,50,100,0,0,0,3024
W7CGA,10,0,10,10,20,0,0,20,0,0,0,10,0,0,0,10,100,100,100,50,0,0,0,0,550
W7DGP,30,0,30,30,60,0,0,60,0,0,0,28,0,0,0,28,100,100,100,50,0,50,0,0,2080
W7GF,28,0,28,28,56,0,0,56,0,3,10,13,0,0,0,26,100,100,100,0,0,0,0,0,1756
W7GKF,101,0,101,100,200,1,1,201,0,0,10,66,0,0,0,76,100,100,100,0,0,0,0,0,15576
W7IY,206,1,205,205,410,0,0,410,0,0,36,86,1,0,0,123,100,100,100,0,0,100,0,0,50830
W7O,175,0,175,0,0,175,175,175,0,0,0,114,0,0,0,114,100,100,100,0,0,0,0,0,20250
W7OSU,5,0,5,0,0,5,5,5,0,0,0,5,0,0,0,5,100,100,100,50,0,0,0,0,375
W7QC,81,0,81,81,162,0,0,162,0,0,42,0,0,0,0,42,100,100,100,50,0,0,0,0,7154
W7QDM,138,0,138,138,276,0,0,276,0,0,14,73,0,0,0,87,100,100,100,0,100,0,0,0,24412
W7RTM,18,0,18,0,0,18,18,18,0,1,4,11,0,0,0,16,100,100,100,0,0,0,0,0,588
W7SE,319,0,319,214,428,105,105,533,0,0,0,141,0,0,0,141,100,100,100,0,0,0,0,0,75453
W7TR,21,0,21,21,42,0,0,42,0,0,2,18,0,0,0,20,100,100,100,0,100,0,0,0,1240
W7VAS,16,0,16,16,32,0,0,32,0,0,0,15,0,0,0,15,100,100,100,50,0,50,0,0,880
W7VXS,53,1,52,52,104,0,0,104,0,0,0,41,0,0,0,41,100,100,100,50,0,0,0,0,4614
W7WEC,66,0,66,66,132,0,0,132,0,0,0,23,0,0,0,23,100,100,100,0,0,0,0,0,3336
W7WSV,23,0,23,23,46,0,0,46,0,0,3,19,0,0,0,22,100,100,100,50,0,0,0,0,1362
W7YG,4,0,4,0,0,4,4,4,0,0,0,4,0,0,0,4,100,100,100,0,0,0,0,0,316
W7ZRC,28,1,27,27,54,0,0,54,0,0,13,13,0,0,0,26,100,100,100,50,0,50,0,0,1804
W8AJS,37,0,37,37,74,0,0,74,0,0,0,30,0,0,0,30,100,100,100,50,0,50,0,0,2620
W8DSB,3,0,3,0,0,3,3,3,0,0,1,2,0,0,0,3,100,100,100,0,0,0,0,0,309
W8EDU,194,1,193,29,58,164,164,222,0,0,71,3,0,0,0,74,100,100,100,50,0,0,0,0,16778
W8HNI,95,1,94,94,188,0,0,188,0,5,25,27,0,0,0,57,100,100,100,50,0,0,0,0,11066
W8KA,251,0,251,251,502,0,0,502,0,0,0,130,2,0,0,132,100,100,100,0,0,100,0,0,66664
W8SBH,37,0,37,0,0,37,37,37,0,0,18,8,0,0,0,26,100,100,100,50,0,0,0,0,1312
W8TK,70,0,70,70,140,0,0,140,0,0,3,46,3,1,0,53,100,100,100,50,0,0,0,0,7770
W8WDW,1,0,1,0,0,1,1,1,0,0,0,0,0,0,0,0,100,100,100,50,0,0,0,0,350
W9AKS,15,0,15,15,30,0,0,30,0,0,0,11,0,0,0,11,100,100,100,50,0,0,0,0,680
W9AV,260,1,259,74,148,185,185,333,0,0,20,105,0,0,0,125,100,100,100,50,0,0,0,0,41975
W9BBF,61,0,61,61,122,0,0,122,0,0,0,34,0,0,0,34,100,100,100,50,100,50,0,0,4648
W9CEQ,19,0,19,0,0,19,19,19,0,0,4,15,0,0,0,19,100,100,100,50,100,100,0,0,911
W9EO,42,0,42,41,82,1,1,83,0,0,6,32,0,0,0,38,100,100,100,50,0,100,0,0,3604
W9FFA,21,0,21,21,42,0,0,42,0,0,1,16,0,0,0,17,100,100,100,0,0,0,0,0,1014
W9S,182,0,182,130,260,52,52,312,1,13,43,48,3,1,0,109,100,100,100,50,0,150,0,0,34508
W9XT,210,9,201,201,402,0,0,402,0,18,59,47,3,0,0,127,100,100,100,0,0,200,0,0,51554
W9XY,445,21,424,120,240,304,304,544,0,0,50,148,1,0,0,199,100,100,100,50,0,0,0,0,108606
WA1FCN,216,1,215,214,428,1,1,429,0,6,64,75,0,0,0,145,100,100,100,0,0,0,0,0,62505
WA1OUI,26,0,26,26,52,0,0,52,0,0,0,25,0,0,0,25,100,100,100,50,0,0,0,0,1650
WA1SAY,88,0,88,88,176,0,0,176,0,0,11,52,0,0,0,63,100,100,100,50,0,100,0,0,11538
WA3AAN,52,0,52,52,104,0,0,104,0,2,17,18,1,0,0,38,100,100,100,50,0,200,0,0,4502
WA3AER,57,4,53,42,84,11,11,95,0,0,17,22,0,0,0,39,100,100,100,50,0,100,0,0,4155
WA4CZD,1,0,1,1,2,0,0,2,0,0,0,0,0,0,0,0,100,100,100,50,0,0,0,0,350
WA4IPU,77,1,76,15,30,61,61,91,0,0,2,52,0,0,0,54,100,100,100,50,0,0,0,0,5264
WA4MLD,50,3,47,47,94,0,0,94,0,0,20,17,0,0,0,37,100,100,100,0,0,0,0,0,3778
WA4VKA,7,0,7,0,0,7,7,7,0,0,1,4,0,0,0,5,100,100,100,0,0,100,0,0,435
WA5KBH,48,2,46,0,0,46,46,46,0,0,0,40,0,0,0,40,100,100,100,0,0,0,0,0,2140
WA5LXS,36,2,34,33,66,1,1,67,0,0,8,22,0,0,0,30,100,100,100,50,0,100,0,0,2460
WA5POK,101,3,98,77,154,21,21,175,0,0,39,27,0,0,0,66,100,100,100,50,100,100,0,0,12100
WA5TVO,48,2,46,44,88,2,2,90,0,0,15,12,1,0,0,28,100,100,100,50,0,0,0,0,2870
WA7BAM,10,0,10,10,20,0,0,20,0,0,0,10,0,0,0,10,100,100,100,50,0,0,0,0,550
WA7DHQ,10,0,10,0,0,10,10,10,0,0,0,10,0,0,0,10,100,100,100,0,0,0,0,0,400
WA7GIL,41,1,40,40,80,0,0,80,0,0,0,29,0,0,0,29,100,100,100,0,0,0,0,0,2620
WA7YXY,8,0,8,0,0,8,8,8,0,0,3,4,0,0,0,7,100,100,100,50,100,100,0,0,606
WA9LEY,66,0,66,66,132,0,0,132,0,0,22,35,0,0,0,57,100,100,100,0,0,0,0,0,7824
WA9PYH,28,0,28,28,56,0,0,56,0,2,9,15,0,0,0,26,100,100,100,50,0,150,0,0,1956
WB0IWG,17,0,17,0,0,17,17,17,0,0,4,12,0,0,0,16,100,100,100,0,0,0,0,0,572
WB0TEV/M,15,0,15,15,30,0,0,30,0,0,0,12,0,0,0,12,100,100,100,50,0,50,0,0,760
WB1CZX,5,1,4,4,8,0,0,8,0,0,0,4,0,0,0,4,100,100,100,50,0,0,0,0,382
WB2COY,16,0,16,16,32,0,0,32,0,0,0,13,0,0,0,13,100,100,100,50,0,0,0,0,766
WB3D,11,0,11,4,8,7,7,15,0,0,0,10,0,0,0,10,100,100,100,0,100,0,0,0,550
WB3LHD,100,1,99,99,198,0,0,198,0,0,0,0,0,0,0,0,100,100,100,50,0,50,0,0,400
WB5UAA,13,0,13,13,26,0,0,26,0,0,0,12,0,0,0,12,100,100,100,50,0,50,50,0,762
WB6OTS,100,0,100,100,200,0,0,200,0,0,0,67,1,0,0,68,100,100,100,50,100,100,0,0,14150
WB9CIF,60,0,60,60,120,0,0,120,0,0,19,34,2,0,0,55,100,100,100,50,100,100,0,0,7150
WB9HCO,18,0,18,0,0,18,18,18,0,0,1,16,0,0,0,17,100,100,100,50,100,0,0,0,756
WB9HFK,155,0,155,155,310,0,0,310,0,5,67,0,0,0,0,72,100,100,100,0,0,0,0,0,22620
WB9IFE,5,0,5,0,0,5,5,5,0,0,0,5,0,0,0,5,100,100,100,0,0,0,0,0,325
WB9MSM,106,1,105,101,202,4,4,206,0,0,18,51,1,0,0,70,100,100,100,50,100,0,0,0,14870
WB9QAF,39,0,39,18,36,21,21,57,0,0,1,26,0,0,0,27,100,100,100,50,0,0,0,0,1889
WC0WB,36,0,36,36,72,0,0,72,0,0,0,15,0,0,0,15,100,100,100,0,0,0,0,0,1380
WD5ABC,1,0,1,1,2,0,0,2,0,0,0,0,1,0,0,1,100,100,100,50,0,50,0,0,402
WD8RIF/4,22,0,22,22,44,0,0,44,0,0,9,12,0,0,0,21,100,100,100,50,0,0,0,0,1274
WF4W,123,0,123,123,246,0,0,246,0,0,50,38,0,0,0,88,100,100,100,50,0,0,0,0,21998
WG2Z,26,0,26,26,52,0,0,52,0,0,0,24,0,0,0,24,100,100,100,50,0,0,0,0,1598
WG4FOC,1,0,1,1,2,0,0,2,0,1,0,0,0,0,0,1,100,100,100,0,0,0,0,0,302
WH7W,16,0,16,16,32,0,0,32,0,0,0,14,0,0,0,14,100,100,100,50,0,50,0,0,848
WI2W,52,2,50,49,98,1,1,99,0,0,20,21,0,0,0,41,100,100,100,50,0,0,0,0,4409
WI7P,3,1,2,0,0,2,2,2,0,0,2,0,0,0,0,2,100,100,100,50,0,0,0,0,354
WM2Z,32,4,28,28,56,0,0,56,0,0,0,25,0,0,0,25,100,100,100,50,0,0,0,0,1750
WM4AA,19,3,16,16,32,0,0,32,0,2,2,12,0,0,0,16,100,100,100,50,0,0,0,0,862
WN4AFP,86,2,84,81,162,3,3,165,0,0,22,3,0,0,0,25,100,100,100,0,0,0,0,0,4425
WS8EOC,32,0,32,32,64,0,0,64,0,10,6,13,0,0,0,29,100,100,100,50,0,0,0,0,2206
WW1ME,62,0,62,62,124,0,0,124,1,5,9,29,0,0,0,44,100,100,100,0,0,0,0,0,5756
WW4SF,47,0,47,37,74,10,10,84,0,0,15,23,0,0,0,38,100,100,100,50,0,0,0,0,3542
WX0M,9,0,9,9,18,0,0,18,0,0,0,9,0,0,0,9,100,100,100,50,0,50,0,0,562
WX8V,51,0,51,35,70,16,16,86,0,4,23,14,0,0,0,41,100,100,100,50,0,0,0,0,3876
XE1B,73,0,73,0,0,73,73,73,0,0,0,52,0,0,0,52,100,100,100,0,0,50,0,0,4146
XE2B,13,0,13,13,26,0,0,26,0,0,0,12,0,0,0,12,100,100,100,0,0,50,0,0,662
YO3APJ,38,0,38,38,76,0,0,76,0,0,0,28,0,0,0,28,100,100,100,0,0,0,0,0,2428
YO3GNF,4,0,4,4,8,0,0,8,0,0,0,4,0,0,0,4,100,100,100,0,0,0,0,0,332
