call,qsos_submitted,qsos_dropped,qsos_valid,cw_qso,cw_qso_pts,ph_qso,ph_qso_pts,total_qso_pts,gs_1,gs_3,gs_7,gs_14,gs_21,gs_28,gs_50,total_gs,operated_totality,operated_outdoors,operated_public,ground_conductivity,antenna_design,erpd,skimmers,iq_data,spot_bonus,total
AA1K,56,0,56,56,112,0,0,112,18,0,0,29,2,0,0,49,100,100,100,50,0,0,0,0,90,5928
AA3B,680,0,680,680,1360,0,0,1360,1,23,99,160,12,1,0,296,100,100,100,50,100,300,0,0,656,403966
AA3WB,24,0,24,0,0,24,24,24,0,0,14,6,0,0,0,20,100,100,100,50,100,0,0,0,0,930
AA4LR,61,1,60,52,104,8,8,112,0,0,20,29,4,1,0,54,100,100,100,50,0,200,0,0,96,6694
AA5AD,27,0,27,27,54,0,0,54,0,0,0,19,0,0,0,19,100,100,100,0,0,0,0,0,38,1364
AA5VN,21,0,21,21,42,0,0,42,0,0,0,15,0,0,0,15,100,100,100,0,0,0,0,0,48,978
AA9K,18,0,18,18,36,0,0,36,0,0,13,0,0,0,0,13,100,100,100,50,0,0,0,0,10,828
AB1J,27,0,27,27,54,0,0,54,0,0,13,1,0,0,0,14,100,100,100,50,0,0,0,0,19,1125
AB3GY,79,1,78,78,156,0,0,156,0,0,51,1,0,0,0,52,100,100,100,50,0,100,100,0,232,8894
AB3RU,8,0,8,8,16,0,0,16,0,0,4,4,0,0,0,8,100,100,100,50,0,0,0,0,9,487
AB4VT,14,0,14,10,20,4,4,24,0,0,2,12,0,0,0,14,100,100,100,50,0,100,0,0,44,830
AB5J,172,0,172,13,26,159,159,185,0,0,0,95,0,0,0,95,100,100,100,50,100,100,0,0,111,18236
AB5XM,6,0,6,6,12,0,0,12,0,0,0,6,0,0,0,6,100,100,100,50,0,0,0,0,113,535
AB7WP,4,0,4,0,0,4,4,4,0,1,3,0,0,0,0,4,100,100,100,50,0,0,0,0,0,366
AB9CA,54,0,54,54,108,0,0,108,0,0,35,0,0,0,0,35,100,100,100,0,0,0,0,0,46,4126
AB9PR,10,0,10,0,0,10,10,10,0,0,0,9,0,0,0,9,100,100,100,50,0,0,0,0,0,440
AB9YC,100,0,100,100,200,0,0,200,0,1,20,46,0,0,0,67,100,100,100,0,0,0,0,0,157,13857
AB9ZZ,37,1,36,36,72,0,0,72,0,0,0,29,0,0,0,29,100,100,100,0,0,0,0,0,14,2402
AC0PR,18,0,18,18,36,0,0,36,0,0,0,17,0,0,0,17,100,100,100,0,0,0,0,0,10,922
AC7AF,49,0,49,49,98,0,0,98,0,0,7,33,1,0,0,41,100,100,100,0,100,0,0,0,74,4492
AC8JW,14,0,14,14,28,0,0,28,0,0,3,11,0,0,0,14,100,100,100,50,0,0,0,0,21,763
AC9AK,13,0,13,7,14,6,6,20,0,0,0,12,0,0,0,12,100,100,100,50,0,0,0,0,2,592
AD0P,86,61,25,22,44,3,3,47,0,0,0,1,0,0,0,1,100,100,100,50,0,50,50,0,579,1076
AD0TA,36,18,18,18,36,0,0,36,0,0,0,18,0,0,0,18,100,100,100,50,0,50,0,0,95,1143
AD4TJ,30,15,15,15,30,0,0,30,0,0,0,11,0,0,0,11,100,100,100,50,100,50,0,0,24,854
AD5KZ,4,2,2,0,0,2,2,2,0,0,0,2,0,0,0,2,100,100,100,50,0,0,0,0,0,354
AD5XD,82,8,74,74,148,0,0,148,0,0,0,53,0,0,0,53,100,100,100,50,0,50,0,0,221,8465
AD6ZR,17,0,17,17,34,0,0,34,0,0,0,15,0,0,0,15,100,100,100,0,0,0,0,0,15,825
AD7KG,33,0,33,17,34,16,16,50,0,0,0,24,0,0,0,24,100,100,100,50,0,0,0,0,37,1587
AE1T,176,0,176,175,350,1,1,351,0,7,28,88,0,0,0,123,100,100,100,50,100,150,0,0,304,44077
AE3J,11,0,11,11,22,0,0,22,0,0,7,4,0,0,0,11,100,100,100,50,0,100,0,0,8,700
AE9LL,3,0,3,3,6,0,0,6,0,0,1,2,0,0,0,3,100,100,100,50,0,250,0,0,0,618
AF0E-7,39,0,39,39,78,0,0,78,0,0,0,32,0,0,0,32,100,100,100,0,0,0,0,0,64,2860
AF4HL,3,0,3,3,6,0,0,6,0,0,0,2,1,0,0,3,100,100,100,50,0,0,0,0,0,368
AF4MP-M,9,0,9,0,0,9,9,9,0,0,9,0,0,0,0,9,100,100,100,0,0,0,0,0,0,381
AF6HC,2,0,2,1,2,1,1,3,0,0,0,1,0,0,0,1,100,100,100,0,0,0,0,0,0,303
AF8A,33,1,32,32,64,0,0,64,0,2,9,18,0,0,0,29,100,100,100,0,0,0,0,0,62,2218
AG7GP,50,0,50,0,0,50,50,50,0,0,25,14,0,0,0,39,100,100,100,50,100,0,0,0,0,2400
AI6IN,12,0,12,0,0,12,12,12,0,0,0,10,0,0,0,10,100,100,100,50,0,50,50,0,32,602
AI6LY,130,0,130,0,0,130,130,130,0,0,6,83,0,0,0,89,100,100,100,50,0,100,0,0,0,12020
AI6SL,15,0,15,15,30,0,0,30,0,0,1,13,0,0,0,14,100,100,100,0,0,0,0,0,1,721
AJ3C,15,0,15,15,30,0,0,30,0,0,0,14,0,0,0,14,100,100,100,0,0,0,0,0,163,883
AJ4PW,36,6,30,0,0,30,30,30,0,0,1,25,0,0,0,26,100,100,100,0,0,0,0,0,0,1080
AJ6T,21,0,21,21,42,0,0,42,0,0,0,15,0,0,0,15,100,100,100,50,0,50,0,0,799,1829
AK0W,10,0,10,10,20,0,0,20,0,0,0,10,0,0,0,10,100,100,100,50,0,50,50,0,82,732
AK4NG,9,0,9,9,18,0,0,18,0,0,3,5,0,0,0,8,100,100,100,50,100,0,0,0,198,792
AK7O,61,1,60,60,120,0,0,120,0,0,0,40,0,0,0,40,100,100,100,0,0,50,0,0,110,5260
AL7LO,57,0,57,56,112,1,1,113,0,0,0,39,0,0,0,39,100,100,100,50,0,50,0,0,161,4968
CG3ZN,17,0,17,1,2,16,16,18,0,0,7,8,0,0,0,15,100,100,100,0,100,0,0,0,0,670
CT7AIX,8,0,8,8,16,0,0,16,0,0,0,8,0,0,0,8,100,100,100,0,0,0,0,0,31,459
EA3-SP5ULN,16,0,16,16,32,0,0,32,0,0,0,16,0,0,0,16,100,100,100,0,0,0,0,0,0,812
F1ABL,43,0,43,43,86,0,0,86,0,0,1,1,1,0,0,3,100,100,100,0,0,150,100,150,3,961
G3LDI,23,0,23,23,46,0,0,46,0,0,0,20,0,0,0,20,100,100,100,0,0,0,0,0,123,1343
G3UCQ,21,0,21,21,42,0,0,42,0,0,0,20,0,0,0,20,100,100,100,0,0,0,0,0,168,1308
G4GIR,9,4,5,5,10,0,0,10,0,0,0,5,0,0,0,5,100,100,100,0,0,0,0,0,77,427
G4KRW,24,12,12,12,24,0,0,24,0,0,12,0,0,0,0,12,100,100,100,50,0,0,0,0,197,835
K0ALB,1,0,1,1,2,0,0,2,0,0,0,1,0,0,0,1,100,100,100,0,0,0,0,0,0,302
K0AV,29,15,14,14,28,0,0,28,0,0,8,5,0,0,0,13,100,100,100,50,100,100,0,0,49,963
K0DTJ,97,16,81,81,162,0,0,162,0,1,19,42,0,0,0,62,100,100,100,0,0,150,0,0,156,10650
K0GUZ,15,0,15,15,30,0,0,30,0,0,7,7,0,0,0,14,100,100,100,0,0,0,0,0,26,746
K0GW,9,0,9,9,18,0,0,18,0,0,0,8,0,0,0,8,100,100,100,0,0,0,0,0,19,463
K0JY,48,0,48,48,96,0,0,96,0,0,0,22,0,0,0,22,100,100,100,0,100,0,0,0,103,2615
K0SAU,11,1,10,10,20,0,0,20,0,0,0,7,0,0,0,7,100,100,100,50,0,0,0,0,7,497
K0TQ,21,0,21,21,42,0,0,42,0,0,18,1,0,0,0,19,100,100,100,50,0,0,0,0,29,1177
K0UA,16,0,16,0,0,16,16,16,0,0,3,13,0,0,0,16,100,100,100,50,0,0,0,0,149,755
K0USA,59,2,57,0,0,57,57,57,0,0,0,44,0,0,0,44,100,100,100,50,0,50,0,0,0,2908
K0VH,16,0,16,10,20,6,6,26,0,0,0,15,0,0,0,15,100,100,100,50,0,150,0,0,50,940
K1AUS,4,0,4,0,0,4,4,4,0,0,0,4,0,0,0,4,100,100,100,50,0,250,0,0,3,619
K1EEE,175,1,174,174,348,0,0,348,0,0,0,0,0,0,0,0,100,100,100,50,0,150,0,0,225,725
K1LOL,33,0,33,33,66,0,0,66,0,0,10,23,0,0,0,33,100,100,100,50,0,0,0,0,380,2908
K1LT,118,1,117,117,234,0,0,234,0,0,66,0,0,0,0,66,100,100,100,0,0,0,0,0,107,15851
K1NKR,5,0,5,0,0,5,5,5,0,0,5,0,0,0,0,5,100,100,100,50,0,50,100,0,0,525
K1NPT,26,1,25,25,50,0,0,50,0,4,16,2,0,0,0,22,100,100,100,50,0,150,500,0,217,2317
K1NZ,3,0,3,3,6,0,0,6,0,0,3,0,0,0,0,3,100,100,100,0,0,0,0,0,75,393
K1OTZ,10,1,9,9,18,0,0,18,0,0,0,3,0,0,0,3,100,100,100,50,0,0,0,0,85,489
K1RV,77,0,77,77,154,0,0,154,2,7,22,19,1,0,0,51,100,100,100,50,0,0,0,0,226,8430
K1XRN,12,0,12,10,20,2,2,22,0,0,12,0,0,0,0,12,100,100,100,0,0,0,0,0,5,569
K2AA,44,1,43,34,68,9,9,77,0,0,7,29,0,0,0,36,100,100,100,50,0,100,0,0,86,3308
K2CIB,173,7,166,11,22,155,155,177,0,0,0,91,0,0,0,91,100,100,100,50,100,50,0,0,42,16649
K2DSW,308,0,308,308,616,0,0,616,0,0,65,101,0,0,0,166,100,100,100,0,0,0,0,0,330,102886
K2GLS,14,0,14,14,28,0,0,28,0,0,2,10,0,0,0,12,100,100,100,50,0,250,0,0,11,947
K2HVE,11,0,11,0,0,11,11,11,0,0,8,0,0,0,0,8,100,100,100,0,0,50,0,0,0,438
K2LE-1,221,11,210,210,420,0,0,420,0,9,13,110,12,0,0,144,100,100,100,0,0,0,0,0,416,61196
K2ND,27,0,27,27,54,0,0,54,0,0,11,15,0,0,0,26,100,100,100,50,0,250,0,0,44,2048
K2OID,42,2,40,40,80,0,0,80,0,0,11,20,0,0,0,31,100,100,100,0,0,50,0,0,43,2873
K2PAA,26,8,18,18,36,0,0,36,0,0,0,13,0,0,0,13,100,100,100,50,100,50,0,0,73,1041
K2PS,50,3,47,47,94,0,0,94,0,0,18,15,3,0,0,36,100,100,100,50,0,0,0,0,116,3850
K2QPN,17,0,17,17,34,0,0,34,0,0,0,17,0,0,0,17,100,100,100,50,0,50,50,50,21,1099
K2RYD,10,1,9,0,0,9,9,9,0,0,2,4,0,0,0,6,100,100,100,50,0,0,0,0,0,404
K3PP,71,0,71,71,142,0,0,142,0,30,18,0,0,0,0,48,100,100,100,50,0,0,0,0,42,7208
K3RRP,5,0,5,0,0,5,5,5,0,0,2,2,0,0,0,4,100,100,100,50,0,0,0,0,0,370
K3VX,26,2,24,24,48,0,0,48,0,0,4,17,0,0,0,21,100,100,100,50,0,100,0,0,50,1508
K3WR,56,0,56,53,106,3,3,109,0,0,0,38,0,0,0,38,100,100,100,50,0,0,0,0,53,4545
K3ZO,233,1,232,232,464,0,0,464,0,23,37,99,0,0,0,159,100,100,100,50,100,0,0,0,251,74477
K4BAI,454,1,453,453,906,0,0,906,3,15,81,145,5,0,0,249,100,100,100,0,0,0,0,0,500,226394
K4E,40,0,40,28,56,12,12,68,0,0,27,11,0,0,0,38,100,100,100,50,0,0,0,0,83,3017
K4FTP,46,1,45,45,90,0,0,90,0,0,8,32,0,0,2,42,100,100,100,0,0,0,0,0,475,4555
K4JWX,9,0,9,0,0,9,9,9,0,0,0,8,0,0,0,8,100,100,100,50,0,50,0,0,0,472
K4LNN,42,1,41,34,68,7,7,75,0,0,0,33,0,0,0,33,100,100,100,0,0,0,0,0,85,2860
K4NAX,77,1,76,76,152,0,0,152,0,0,38,15,0,0,0,53,100,100,100,0,0,0,0,0,107,8463
K4RUM,44,0,44,44,88,0,0,88,0,0,5,31,1,0,0,37,100,100,100,0,0,0,0,0,132,3688
K4SBZ,41,0,41,41,82,0,0,82,0,0,0,32,2,0,0,34,100,100,100,0,0,0,0,0,466,3554
K4VOZ,14,0,14,9,18,5,5,23,0,0,2,10,0,1,0,13,100,100,100,0,0,0,0,0,82,681
K4WES,75,0,75,0,0,75,75,75,0,0,0,54,0,0,0,54,100,100,100,0,0,0,0,0,0,4350
K4YYL,19,0,19,19,38,0,0,38,0,17,0,0,0,0,0,17,100,100,100,50,0,50,0,0,26,1072
K4ZGB,12,0,12,12,24,0,0,24,0,0,11,1,0,0,0,12,100,100,100,0,0,0,0,0,52,640
K5CS,25,0,25,25,50,0,0,50,0,2,6,14,0,0,0,22,100,100,100,50,0,0,0,0,51,1501
K5NA,10,0,10,10,20,0,0,20,10,0,0,0,0,0,0,10,100,100,100,0,0,0,0,0,9,509
K5NMT,38,0,38,0,0,38,38,38,0,0,1,29,0,0,0,30,100,100,100,50,100,0,0,0,0,1590
K5PM,34,3,31,3,6,28,28,34,0,0,1,23,0,0,0,24,100,100,100,50,100,100,100,100,0,1566
K5QR,15,0,15,15,30,0,0,30,0,0,3,9,0,0,0,12,100,100,100,0,0,0,0,0,3,663
K5VOP,11,1,10,10,20,0,0,20,0,0,2,7,0,0,0,9,100,100,100,50,0,0,0,0,492,1022
K6DGQ,5,0,5,5,10,0,0,10,0,0,0,4,0,0,0,4,100,100,100,0,0,0,0,0,17,357
K6DLB,14,0,14,0,0,14,14,14,0,0,0,13,0,0,0,13,100,100,100,0,0,0,0,0,124,606
K6LA,196,2,194,176,352,18,18,370,0,0,1,100,11,0,0,112,100,100,100,50,100,0,0,0,244,42134
K6RB,200,11,189,189,378,0,0,378,0,0,1,1,0,0,0,2,100,100,100,50,100,100,0,0,258,1564
K6VUG,15,7,8,8,16,0,0,16,0,0,0,8,0,0,0,8,100,100,100,50,0,50,0,0,22,550
K7AZT,33,17,16,16,32,0,0,32,0,0,5,11,0,0,0,16,100,100,100,50,0,100,0,0,112,1074
K7EFA,23,11,12,4,8,8,8,16,0,0,0,11,0,0,0,11,100,100,100,50,0,50,0,0,17,593
K7JNA,13,7,6,6,12,0,0,12,0,0,0,4,0,0,0,4,100,100,100,0,0,0,0,0,288,636
K7NWM,6,3,3,0,0,3,3,3,0,0,0,3,0,0,0,3,100,100,100,50,100,0,0,0,0,459
K7RBT,6,3,3,3,6,0,0,6,0,0,0,3,0,0,0,3,100,100,100,0,0,0,0,0,6,324
K7SDW,25,12,13,13,26,0,0,26,0,0,0,13,0,0,0,13,100,100,100,50,0,0,0,0,53,741
K7ULS,11,6,5,5,10,0,0,10,0,0,5,0,0,0,0,5,100,100,100,0,0,0,0,0,24,374
K7VIT,80,40,40,40,80,0,0,80,0,0,0,26,0,0,0,26,100,100,100,50,100,50,0,0,64,2644
K7Y,27,13,14,9,18,5,5,23,0,0,1,12,0,0,0,13,100,100,100,0,0,0,0,0,51,650
K7YMA,7,4,3,0,0,3,3,3,0,0,0,3,0,0,0,3,100,100,100,50,0,0,0,0,0,359
K8AG-0,3,1,2,2,4,0,0,4,0,0,0,2,0,0,0,2,100,100,100,0,0,0,0,0,2,310
K8BTU,62,31,31,31,62,0,0,62,0,6,18,2,0,0,0,26,100,100,100,50,0,0,0,0,60,2022
K8BZ,31,16,15,15,30,0,0,30,0,0,6,9,0,0,0,15,100,100,100,50,100,0,0,0,53,953
K8GT,37,18,19,19,38,0,0,38,0,5,6,8,0,0,0,19,100,100,100,50,0,150,0,0,38,1260
K8LBQ,52,7,45,45,90,0,0,90,0,0,0,25,0,0,0,25,100,100,100,0,0,0,0,0,86,2636
K8PJK,19,0,19,19,38,0,0,38,0,0,9,8,0,0,0,17,100,100,100,50,0,0,0,0,282,1278
K8RO-3,60,1,59,59,118,0,0,118,0,0,0,39,0,0,0,39,100,100,100,0,0,0,0,0,72,4974
K8SAS,41,0,41,41,82,0,0,82,0,0,7,28,0,0,0,35,100,100,100,50,100,0,0,0,87,3407
K8UTT,108,0,108,4,8,104,104,112,0,0,42,21,0,0,0,63,100,100,100,0,0,100,0,0,0,7456
K8YE,65,0,65,65,130,0,0,130,0,0,1,31,0,0,0,32,100,100,100,0,0,0,0,0,67,4527
K8ZT,23,1,22,22,44,0,0,44,0,0,1,19,0,0,0,20,100,100,100,50,0,0,0,0,71,1301
K9BGL,437,7,430,382,764,48,48,812,13,11,71,122,2,0,0,219,100,100,100,0,0,0,0,0,448,178576
K9BTQ,23,1,22,20,40,2,2,42,0,0,3,17,0,0,0,20,100,100,100,0,0,0,0,0,35,1175
K9KEU,103,103,0,0,0,0,0,0,0,3,12,48,1,0,0,64,100,100,100,50,0,350,0,0,186,886
K9KM,76,76,0,0,0,0,0,0,0,0,18,33,0,0,0,51,100,100,100,50,100,100,0,0,137,687
K9QJS,33,33,0,0,0,0,0,0,0,0,0,2,0,0,0,2,100,100,100,0,0,0,0,0,39,339
K9VER,31,31,0,0,0,0,0,0,0,0,0,6,0,0,0,6,100,100,100,0,0,0,0,0,523,823
KA1PPV,19,19,0,0,0,0,0,0,0,0,12,3,0,0,0,15,100,100,100,50,100,0,0,0,15,465
KA2BXH,5,5,0,0,0,0,0,0,0,0,0,4,0,0,0,4,100,100,100,0,0,0,0,0,2,302
KA3MTT,6,6,0,0,0,0,0,0,0,0,1,1,0,0,0,2,100,100,100,0,0,0,0,0,3,303
KA3SME,6,6,0,0,0,0,0,0,0,0,6,0,0,0,0,6,100,100,100,0,0,50,0,0,0,350
KA4WJB,33,33,0,0,0,0,0,0,0,0,10,13,0,0,0,23,100,100,100,50,0,0,0,0,46,396
KA5TTZ,27,27,0,0,0,0,0,0,0,0,1,18,0,0,0,19,100,100,100,50,100,100,0,0,0,550
KA6BID,2,2,0,0,0,0,0,0,0,0,1,0,0,0,0,1,100,100,100,0,0,0,0,0,14,314
KA9GDW,4,4,0,0,0,0,0,0,0,0,0,0,0,0,0,0,100,100,100,50,0,0,0,0,0,350
KA9OKH,87,87,0,0,0,0,0,0,0,0,35,0,0,0,0,35,100,100,100,50,0,50,50,0,294,744
KB0LQJ,5,5,0,0,0,0,0,0,0,0,0,2,0,0,0,2,100,100,100,50,0,0,0,0,76,426
KB0SS,28,28,0,0,0,0,0,0,0,0,0,14,0,0,0,14,100,100,100,0,0,50,0,0,0,350
KB1BMF,24,24,0,0,0,0,0,0,0,0,4,6,0,0,0,10,100,100,100,50,0,0,0,0,82,432
KB1BSR,19,19,0,0,0,0,0,0,0,0,14,0,0,0,0,14,100,100,100,50,0,0,0,0,274,624
KB1HZM,23,23,0,0,0,0,0,0,0,0,16,0,0,0,0,16,100,100,100,0,0,0,0,0,11,311
KB1IRB,8,8,0,0,0,0,0,0,0,0,0,7,0,0,0,7,100,100,100,50,100,0,0,0,0,450
KB1WXM,107,107,0,0,0,0,0,0,0,0,0,54,0,0,0,54,100,100,100,50,0,50,0,0,0,400
KB2PSI,1,1,0,0,0,0,0,0,0,0,0,1,0,0,0,1,100,100,100,50,0,0,0,0,0,350
KB3AAY,181,181,0,0,0,0,0,0,0,0,28,44,0,0,0,72,100,100,100,0,0,0,0,0,160,460
KB3LIX,54,54,0,0,0,0,0,0,0,0,31,10,0,0,0,41,100,100,100,0,0,100,0,0,46,446
KB3ORG,6,6,0,0,0,0,0,0,0,0,1,4,0,0,0,5,100,100,100,50,100,150,0,0,0,600
KB3SBC,32,32,0,0,0,0,0,0,0,0,8,13,0,0,0,21,100,100,100,50,0,100,0,0,194,644
KB4MG,15,15,0,0,0,0,0,0,0,0,0,14,0,0,0,14,100,100,100,50,0,0,0,0,33,383
KB6IGK,12,12,0,0,0,0,0,0,0,0,0,11,0,0,0,11,100,100,100,0,0,0,0,0,4,304
KB6NU,100,100,0,0,0,0,0,0,0,0,43,0,0,0,0,43,100,100,100,50,0,50,0,0,85,485
KB8GAE,65,65,0,0,0,0,0,0,2,8,27,12,0,0,0,49,100,100,100,50,100,0,0,0,183,633
KB8ZGL,231,231,0,0,0,0,0,0,0,0,0,116,0,0,0,116,100,100,100,50,0,0,0,0,0,350
KB9EWG,4,4,0,0,0,0,0,0,0,0,0,4,0,0,0,4,100,100,100,0,0,0,0,0,175,475
KC0BYE,12,12,0,0,0,0,0,0,0,0,0,12,0,0,0,12,100,100,100,50,0,50,0,0,15,415
KC0P,22,22,0,0,0,0,0,0,0,0,7,0,0,0,0,7,100,100,100,50,100,50,0,0,52,552
KC1AEO,5,5,0,0,0,0,0,0,0,0,0,3,0,0,0,3,100,100,100,50,0,0,0,0,0,350
KC1SA,10,10,0,0,0,0,0,0,0,0,1,9,0,0,0,10,100,100,100,0,0,100,0,0,12,412
KC2JJQ,4,4,0,0,0,0,0,0,0,0,2,1,0,0,0,3,100,100,100,0,0,0,0,0,0,300
KC2SWB,25,25,0,0,0,0,0,0,0,0,0,22,0,0,0,22,100,100,100,50,100,0,0,0,44,494
KC2WUF,11,11,0,0,0,0,0,0,0,1,5,1,0,0,0,7,100,100,100,0,0,0,0,0,71,371
KC3ASH,4,4,0,0,0,0,0,0,0,0,2,2,0,0,0,4,100,100,100,50,0,0,0,0,0,350
KC3FDA,10,10,0,0,0,0,0,0,0,0,0,8,0,0,0,8,100,100,100,50,100,0,0,0,512,962
KC4AUF,50,50,0,0,0,0,0,0,0,0,0,36,0,0,0,36,100,100,100,50,100,50,0,0,90,590
KC4SI,2,2,0,0,0,0,0,0,0,0,2,0,0,0,0,2,100,100,100,50,0,0,0,0,5,355
KC5DCT,16,16,0,0,0,0,0,0,0,0,0,15,0,0,0,15,100,100,100,50,0,0,0,0,9,359
KC6MIE,12,12,0,0,0,0,0,0,0,0,0,10,0,0,0,10,100,100,100,0,0,0,0,0,0,300
KC6ZKT,6,6,0,0,0,0,0,0,0,0,0,6,0,0,0,6,100,100,100,50,0,0,0,0,0,350
KC8RPV,29,29,0,0,0,0,0,0,0,0,11,14,0,0,0,25,100,100,100,0,100,200,0,0,51,651
KC9UNL,21,21,0,0,0,0,0,0,0,0,17,0,0,0,0,17,100,100,100,0,0,0,0,0,75,375
KC9UXC,4,4,0,0,0,0,0,0,0,0,0,0,0,0,0,0,100,100,100,50,0,0,0,0,0,350
KD0FZT,13,13,0,0,0,0,0,0,0,0,0,11,0,0,0,11,100,100,100,0,0,0,0,0,0,300
KD0IRW,76,76,0,0,0,0,0,0,0,0,16,45,0,0,0,61,100,100,100,0,0,0,0,0,21,321
KD1YV,3,3,0,0,0,0,0,0,0,0,0,3,0,0,0,3,100,100,100,50,0,0,0,0,23,373
KD2ABK,4,4,0,0,0,0,0,0,0,0,3,1,0,0,0,4,100,100,100,0,0,0,0,0,0,300
KD2GUD,26,26,0,0,0,0,0,0,0,0,18,3,0,0,0,21,100,100,100,50,0,0,0,0,30,380
KD2HJZ,93,93,0,0,0,0,0,0,0,0,44,24,0,0,0,68,100,100,100,0,0,100,0,0,27,427
KD2HWE,6,6,0,0,0,0,0,0,0,0,2,4,0,0,0,6,100,100,100,50,100,0,0,0,0,450
KD2MI,29,29,0,0,0,0,0,0,0,0,16,0,0,0,0,16,100,100,100,50,0,50,0,0,16,416
KD3TB,20,20,0,0,0,0,0,0,0,2,7,7,0,0,0,16,100,100,100,0,0,0,0,0,32,332
KD4QIT,19,19,0,0,0,0,0,0,0,0,15,0,0,0,0,15,100,100,100,0,0,50,0,0,106,456
KD4UYP,4,4,0,0,0,0,0,0,0,0,0,4,0,0,0,4,100,100,100,50,100,50,0,0,0,500
KD5HIP,30,30,0,0,0,0,0,0,0,0,24,0,0,0,0,24,100,100,100,50,0,0,0,0,161,511
KD5ILA,80,80,0,0,0,0,0,0,0,0,28,38,0,0,0,66,100,100,100,0,0,0,0,0,65,365
KD5KC,27,27,0,0,0,0,0,0,0,0,0,26,0,0,0,26,100,100,100,0,0,50,0,0,873,1223
KD8DEU,75,75,0,0,0,0,0,0,0,0,15,34,0,0,0,49,100,100,100,0,0,0,0,0,109,409
KD8UPX,7,7,0,0,0,0,0,0,0,0,2,5,0,0,0,7,100,100,100,0,0,0,0,0,0,300
KD9CLH,37,37,0,0,0,0,0,0,0,0,0,33,0,0,0,33,100,100,100,50,0,0,0,0,95,445
KE0LCS,29,29,0,0,0,0,0,0,0,0,0,23,0,0,0,23,100,100,100,50,0,100,100,0,229,779
KE0TT,96,96,0,0,0,0,0,0,0,0,10,41,0,0,0,51,100,100,100,50,0,0,0,0,91,441
KE1B,203,203,0,0,0,0,0,0,0,0,0,113,0,0,0,113,100,100,100,0,0,50,0,0,172,522
KE4GVO,15,15,0,0,0,0,0,0,0,0,13,1,0,0,0,14,100,100,100,50,0,0,0,0,8,358
KE8BYM,43,43,0,0,0,0,0,0,0,0,0,18,0,0,1,19,100,100,100,50,0,0,0,0,293,643
KF7GGN,24,24,0,0,0,0,0,0,0,0,2,19,0,0,0,21,100,100,100,50,0,0,0,0,15,365
KG2DWS,3,3,0,0,0,0,0,0,0,0,0,3,0,0,0,3,100,100,100,0,0,0,0,0,0,300
KG4GVJ,6,6,0,0,0,0,0,0,0,0,2,4,0,0,0,6,100,100,100,50,100,0,0,0,2,452
KG4NXT,27,27,0,0,0,0,0,0,0,0,12,10,0,0,0,22,100,100,100,0,0,0,0,0,30,330
KG5LRP,295,295,0,0,0,0,0,0,0,0,0,117,0,0,0,117,100,100,100,50,0,0,0,0,107,457
KG5THG,37,37,0,0,0,0,0,0,0,0,0,34,0,0,0,34,100,100,100,50,0,0,0,0,653,1003
KG7DMI,4,4,0,0,0,0,0,0,0,0,0,4,0,0,0,4,100,100,100,0,0,0,0,0,8,308
KI0F,87,87,0,0,0,0,0,0,0,0,0,53,0,0,0,53,100,100,100,50,0,0,0,0,49,399
KI0G,16,16,0,0,0,0,0,0,0,0,9,0,0,0,0,9,100,100,100,0,0,50,0,0,42,392
KI4CJT,17,17,0,0,0,0,0,0,0,0,7,3,0,0,0,10,100,100,100,0,100,0,0,0,30,430
KI4FW,25,25,0,0,0,0,0,0,0,0,0,19,1,0,0,20,100,100,100,50,0,100,0,0,19,469
KI4JVE,38,38,0,0,0,0,0,0,0,0,7,20,0,0,0,27,100,100,100,50,100,100,0,50,0,600
KI4MZC,40,40,0,0,0,0,0,0,0,4,17,13,0,0,0,34,100,100,100,50,100,150,0,0,19,619
KI5SC,11,11,0,0,0,0,0,0,0,0,0,0,0,0,0,0,100,100,100,0,100,0,0,0,0,400
KJ4TOZ,47,47,0,0,0,0,0,0,0,0,29,0,0,0,0,29,100,100,100,0,0,0,0,0,4,304
KJ6BQM,14,14,0,0,0,0,0,0,0,0,0,13,0,0,0,13,100,100,100,0,0,50,0,0,311,661
KJ6KCG,16,16,0,0,0,0,0,0,0,0,0,14,0,0,0,14,100,100,100,50,100,0,0,0,0,450
KJ9C,132,132,0,0,0,0,0,0,0,5,24,65,0,0,0,94,100,100,100,50,0,150,300,0,294,1094
KK1VT,3,3,0,0,0,0,0,0,0,0,2,1,0,0,0,3,100,100,100,0,0,0,0,0,0,300
KK3Q,25,25,0,0,0,0,0,0,0,0,12,7,3,0,0,22,100,100,100,50,100,0,0,0,175,625
KK4AGN,48,48,0,0,0,0,0,0,0,0,4,35,0,0,0,39,100,100,100,0,0,0,0,0,0,300
KK4BZ,36,36,0,0,0,0,0,0,0,0,14,7,0,0,0,21,100,100,100,50,100,0,0,0,0,450
KK4MWC,1,1,0,0,0,0,0,0,0,0,0,1,0,0,0,1,100,100,100,50,0,0,0,0,0,350
KK4TSS,28,28,0,0,0,0,0,0,0,1,17,6,0,0,0,24,100,100,100,50,0,0,0,0,135,485
KK5HT,44,44,0,0,0,0,0,0,0,0,0,31,0,0,0,31,100,100,100,0,0,0,0,0,175,475
KK6L,12,12,0,0,0,0,0,0,0,0,2,10,0,0,0,12,100,100,100,50,0,50,0,0,9,409
KK6MLY,9,9,0,0,0,0,0,0,0,0,0,8,0,0,0,8,100,100,100,50,0,150,0,0,0,500
KM1G,7,7,0,0,0,0,0,0,0,0,2,3,2,0,0,7,100,100,100,0,0,0,0,0,1,301
KM4FLU,21,21,0,0,0,0,0,0,0,0,0,15,0,0,0,15,100,100,100,0,0,0,0,0,15,315
KM4HI,110,110,0,0,0,0,0,0,0,0,0,65,3,0,3,71,100,100,100,50,0,0,0,0,484,834
KM4OZH,6,6,0,0,0,0,0,0,0,0,4,2,0,0,0,6,100,100,100,50,0,100,0,0,0,450
KM4RKT,19,19,0,0,0,0,0,0,0,0,13,0,0,0,0,13,100,100,100,0,0,0,0,0,0,300
KM4VCF,14,14,0,0,0,0,0,0,0,0,5,9,0,0,0,14,100,100,100,0,0,0,0,0,0,300
KM4VCO,17,17,0,0,0,0,0,0,0,0,9,4,0,0,0,13,100,100,100,50,100,200,100,100,0,850
KM4YMI,32,32,0,0,0,0,0,0,0,0,15,10,0,0,0,25,100,100,100,50,0,0,0,0,94,444
KN4FRG,130,130,0,0,0,0,0,0,0,0,52,35,1,0,0,88,100,100,100,0,0,150,0,0,0,450
KN4Y,15,15,0,0,0,0,0,0,0,0,0,0,0,12,0,12,100,100,100,0,0,0,0,0,34,334
KP3LH,46,46,0,0,0,0,0,0,0,0,0,30,0,3,0,33,100,100,100,0,0,200,0,0,120,620
KP4RP,10,10,0,0,0,0,0,0,0,0,0,0,0,0,0,0,100,100,100,0,0,50,50,0,233,633
KR7RK,11,11,0,0,0,0,0,0,0,0,2,3,0,3,0,8,100,100,100,50,0,0,0,0,40,390
KS0M,19,19,0,0,0,0,0,0,0,0,0,12,0,0,0,12,100,100,100,0,0,0,0,0,18,318
KS3K,35,35,0,0,0,0,0,0,0,0,0,24,0,0,0,24,100,100,100,0,0,0,0,0,20,320
KS4S,39,39,0,0,0,0,0,0,0,0,27,0,0,0,0,27,100,100,100,0,0,0,0,0,70,370
KS6M,19,19,0,0,0,0,0,0,0,0,0,12,0,0,0,12,100,100,100,0,0,0,0,0,168,468
KT3L,56,56,0,0,0,0,0,0,0,2,29,6,0,0,0,37,100,100,100,50,0,0,0,0,203,553
KT3P,9,9,0,0,0,0,0,0,0,0,6,1,0,0,0,7,100,100,100,0,0,0,0,0,82,382
KT4BOB,4,4,0,0,0,0,0,0,0,0,3,1,0,0,0,4,100,100,100,0,0,0,0,0,57,357
KT4Q,188,188,0,0,0,0,0,0,0,0,4,92,0,0,0,96,100,100,100,0,0,100,0,0,68,468
KT5LA,20,20,0,0,0,0,0,0,0,0,0,16,0,0,0,16,100,100,100,50,0,0,0,0,7,357
KT8TD,8,8,0,0,0,0,0,0,0,0,0,6,2,0,0,8,100,100,100,0,0,0,0,0,0,300
KU4V,69,69,0,0,0,0,0,0,0,0,8,37,1,0,0,46,100,100,100,50,0,0,0,0,77,427
KW0J,97,97,0,0,0,0,0,0,0,0,29,40,4,0,0,73,100,100,100,50,100,0,0,0,104,554
KW0KW,1,1,0,0,0,0,0,0,0,0,0,0,0,0,0,0,100,100,100,50,100,0,0,0,0,450
KW1NG,23,23,0,0,0,0,0,0,0,0,10,11,0,0,0,21,100,100,100,50,100,0,0,0,33,483
KW9R,72,72,0,0,0,0,0,0,0,0,45,0,0,0,0,45,100,100,100,50,0,0,0,0,142,492
KX4KU,17,17,0,0,0,0,0,0,0,0,13,1,0,0,0,14,100,100,100,50,0,0,0,0,27,377
LU5FF,29,29,0,0,0,0,0,0,0,0,0,23,1,0,0,24,100,100,100,0,100,100,100,0,363,963
N0AXZ,22,22,0,0,0,0,0,0,0,0,0,16,0,0,0,16,100,100,100,0,0,0,0,0,152,452
N0BUI,71,71,0,0,0,0,0,0,0,0,17,35,0,0,0,52,100,100,100,0,0,0,0,0,167,467
N0DIM,7,7,0,0,0,0,0,0,0,0,0,7,0,0,0,7,100,100,100,50,0,0,0,0,0,350
N0GB,52,52,0,0,0,0,0,0,0,0,17,21,0,0,0,38,100,100,100,0,0,100,0,0,325,725
N0GOS,35,35,0,0,0,0,0,0,0,0,0,20,0,0,0,20,100,100,100,0,0,0,0,0,34,334
N0KQ,50,50,0,0,0,0,0,0,0,0,0,44,1,0,0,45,100,100,100,0,0,50,0,0,22,372
N0NM,117,117,0,0,0,0,0,0,0,0,0,83,0,0,0,83,100,100,100,0,0,0,0,0,120,420
N0UK,58,58,0,0,0,0,0,0,0,0,0,39,0,0,0,39,100,100,100,50,100,50,0,0,93,593
N0UV,129,129,0,0,0,0,0,0,0,0,0,44,0,0,0,44,100,100,100,0,0,0,0,0,70,370
N1COR,15,15,0,0,0,0,0,0,0,0,0,7,0,0,0,7,100,100,100,50,0,0,0,0,11,361
N1DC,102,102,0,0,0,0,0,0,0,7,12,50,0,0,0,69,100,100,100,0,0,0,0,0,159,459
N1FI,8,8,0,0,0,0,0,0,0,0,0,8,0,0,0,8,100,100,100,50,0,0,0,0,0,350
N1FTP,21,21,0,0,0,0,0,0,0,0,7,11,0,0,0,18,100,100,100,50,0,100,0,0,0,450
N1IA,16,16,0,0,0,0,0,0,0,0,0,13,0,0,0,13,100,100,100,0,0,0,0,0,260,560
N1IXF,116,116,0,0,0,0,0,0,0,0,1,41,0,0,0,42,100,100,100,50,0,0,0,0,91,441
N1MD,72,72,0,0,0,0,0,0,0,0,0,40,0,0,0,40,100,100,100,50,0,0,0,0,76,426
N1NN,13,13,0,0,0,0,0,0,0,0,1,12,0,0,0,13,100,100,100,0,0,0,0,0,11,311
N1SER,2,2,0,0,0,0,0,0,0,0,0,2,0,0,0,2,100,100,100,0,0,0,0,0,12,312
N2CG,31,31,0,0,0,0,0,0,0,0,0,25,0,0,0,25,100,100,100,50,0,50,0,0,69,469
N2ESP,31,31,0,0,0,0,0,0,0,0,2,26,0,0,0,28,100,100,100,50,0,0,0,0,38,388
N2FYE,15,15,0,0,0,0,0,0,0,0,0,1,0,0,0,1,100,100,100,0,100,0,0,0,9,409
N2HTT,9,9,0,0,0,0,0,0,0,1,4,4,0,0,0,9,100,100,100,0,0,0,0,0,23,323
N2KND,7,7,0,0,0,0,0,0,0,0,0,6,0,0,0,6,100,100,100,50,100,250,0,0,48,748
N3AO,38,38,0,0,0,0,0,0,0,0,17,12,0,0,0,29,100,100,100,0,0,0,0,0,47,347
N3ATE,4,4,0,0,0,0,0,0,0,0,4,0,0,0,0,4,100,100,100,50,0,0,0,0,0,350
N3FWE,13,13,0,0,0,0,0,0,0,0,11,2,0,0,0,13,100,100,100,0,0,0,0,0,61,361
N3HEE,128,128,0,0,0,0,0,0,0,1,46,32,1,0,0,80,100,100,100,0,0,0,0,0,143,443
N3KN,67,67,0,0,0,0,0,0,0,3,30,16,0,0,0,49,100,100,100,0,0,0,0,0,245,545
N3MLB,22,22,0,0,0,0,0,0,0,1,6,12,0,0,0,19,100,100,100,50,0,150,0,0,23,523
N3SW,40,40,0,0,0,0,0,0,0,5,14,17,0,0,0,36,100,100,100,50,0,0,0,0,61,411
N3TWM,25,25,0,0,0,0,0,0,0,0,9,10,0,0,0,19,100,100,100,50,100,0,0,0,36,486
N4BAT,21,21,0,0,0,0,0,0,0,0,0,18,0,0,0,18,100,100,100,50,0,0,0,0,0,350
N4BP,444,444,0,0,0,0,0,0,0,0,0,166,0,0,0,166,100,100,100,0,0,0,0,0,441,741
N4BTA,47,47,0,0,0,0,0,0,0,0,21,13,0,0,0,34,100,100,100,50,100,100,0,0,72,622
N4DLT,14,14,0,0,0,0,0,0,0,0,0,10,0,0,0,10,100,100,100,50,0,0,0,0,138,488
N4E,8,8,0,0,0,0,0,0,0,0,8,0,0,0,0,8,100,100,100,0,0,0,0,0,0,300
N4HAI,55,55,0,0,0,0,0,0,0,0,26,11,0,0,0,37,100,100,100,50,100,0,0,0,96,546
N4NM,42,42,0,0,0,0,0,0,0,0,11,24,0,0,0,35,100,100,100,0,0,0,0,0,126,426
N4NO,161,161,0,0,0,0,0,0,8,22,62,0,0,0,0,92,100,100,100,50,0,150,0,0,171,671
N4QM,75,75,0,0,0,0,0,0,0,0,39,0,0,0,0,39,100,100,100,50,0,50,0,0,65,465
N4QS,146,146,0,0,0,0,0,0,0,20,20,75,1,0,0,116,100,100,100,0,0,0,0,0,205,505
N4RDZ,1,1,0,0,0,0,0,0,0,1,0,0,0,0,0,1,100,100,100,50,0,0,0,0,0,350
N4VUG,10,10,0,0,0,0,0,0,0,0,0,9,0,0,0,9,100,100,100,0,0,0,0,0,214,514
N4YDU,225,225,0,0,0,0,0,0,0,9,52,70,3,0,0,134,100,100,100,0,0,0,0,0,218,518
N5EE,122,122,0,0,0,0,0,0,0,1,19,70,0,0,0,90,100,100,100,50,0,150,0,0,190,690
N5EKW,9,9,0,0,0,0,0,0,0,0,0,9,0,0,0,9,100,100,100,50,0,0,0,0,42,392
N5RHS,5,5,0,0,0,0,0,0,0,0,0,5,0,0,0,5,100,100,100,50,100,0,0,0,0,450
N5ZC,254,254,0,0,0,0,0,0,0,0,0,134,0,0,0,134,100,100,100,50,0,0,0,0,183,533
N5ZO,136,136,0,0,0,0,0,0,0,0,0,94,2,0,0,96,100,100,100,0,0,0,0,0,146,446
N5ZY,37,37,0,0,0,0,0,0,0,2,11,22,0,0,0,35,100,100,100,50,0,150,0,0,1154,1654
N6BCT,7,7,0,0,0,0,0,0,0,0,0,7,0,0,0,7,100,100,100,50,100,0,0,0,8,458
N6GP,11,11,0,0,0,0,0,0,0,0,0,11,0,0,0,11,100,100,100,0,0,0,0,0,74,374
N6IC,18,18,0,0,0,0,0,0,0,0,0,17,0,0,0,17,100,100,100,0,0,0,0,0,45,345
N6MRS,1,1,0,0,0,0,0,0,0,0,0,1,0,0,0,1,100,100,100,0,0,0,0,0,0,300
N6OI,28,28,0,0,0,0,0,0,0,0,0,18,0,0,0,18,100,100,100,50,0,50,0,0,56,456
N6REK,7,7,0,0,0,0,0,0,0,0,2,5,0,0,0,7,100,100,100,0,0,0,0,0,159,459
N7EIE,25,25,0,0,0,0,0,0,0,3,2,18,0,0,0,23,100,100,100,50,0,150,0,0,35,535
N7GOA,62,62,0,0,0,0,0,0,0,0,6,36,0,0,0,42,100,100,100,50,100,0,0,0,73,523
N7MSI,5,5,0,0,0,0,0,0,0,0,0,5,0,0,0,5,100,100,100,50,0,0,0,0,0,350
N7RCS,12,12,0,0,0,0,0,0,0,0,8,2,0,0,0,10,100,100,100,0,0,200,0,0,36,536
N7S,115,115,0,0,0,0,0,0,0,0,13,72,1,0,0,86,100,100,100,0,0,0,0,0,183,483
N7TWS,13,13,0,0,0,0,0,0,0,0,0,1,0,0,0,1,100,100,100,50,0,50,0,0,58,458
N7WY,101,101,0,0,0,0,0,0,0,0,5,56,0,0,0,61,100,100,100,50,0,0,0,0,95,445
N8BD,9,9,0,0,0,0,0,0,0,0,7,1,0,0,0,8,100,100,100,50,0,0,0,0,0,350
N8FYL,32,32,0,0,0,0,0,0,0,0,17,12,0,0,0,29,100,100,100,0,0,0,0,0,166,466
N8HM,17,17,0,0,0,0,0,0,0,0,0,12,0,0,0,12,100,100,100,0,0,50,0,0,148,498
N8KR,60,60,0,0,0,0,0,0,0,0,21,14,0,0,0,35,100,100,100,50,0,0,0,0,71,421
N8NFE,18,18,0,0,0,0,0,0,0,1,10,5,0,0,0,16,100,100,100,50,0,0,0,0,81,431
N8PW,397,397,0,0,0,0,0,0,0,0,113,0,0,0,0,113,100,100,100,50,0,50,0,0,203,603
N8SK,11,11,0,0,0,0,0,0,0,0,0,9,0,0,0,9,100,100,100,50,0,0,0,0,274,624
N8SOP,5,5,0,0,0,0,0,0,0,0,3,2,0,0,0,5,100,100,100,50,100,100,0,0,1,551
N8TCP,19,19,0,0,0,0,0,0,0,0,3,14,0,0,0,17,100,100,100,0,0,0,0,0,1,301
N8TFD,6,6,0,0,0,0,0,0,0,1,5,0,0,0,0,6,100,100,100,0,0,0,0,0,0,300
N8VQG,7,7,0,0,0,0,0,0,0,0,3,4,0,0,0,7,100,100,100,0,0,0,0,0,0,300
N9BD,9,9,0,0,0,0,0,0,0,0,0,9,0,0,0,9,100,100,100,50,0,50,0,50,0,450
N9EP,97,97,0,0,0,0,0,0,4,2,31,31,0,0,0,68,100,100,100,50,100,200,450,0,132,1232
N9JF,53,53,0,0,0,0,0,0,0,0,12,27,0,0,0,39,100,100,100,50,0,0,0,0,87,437
N9WL,8,8,0,0,0,0,0,0,0,0,0,8,0,0,0,8,100,100,100,50,100,50,0,0,1,501
NA2X,22,22,0,0,0,0,0,0,0,11,0,0,0,0,0,11,100,100,100,50,0,0,0,0,17,367
NB0Z,26,26,0,0,0,0,0,0,0,0,1,20,0,0,0,21,100,100,100,0,0,0,0,0,21,321
NC4MI,38,38,0,0,0,0,0,0,0,0,6,26,0,0,0,32,100,100,100,0,0,200,0,0,38,538
NC4RT,11,11,0,0,0,0,0,0,0,0,4,7,0,0,0,11,100,100,100,50,0,150,0,0,58,558
NC6Q,19,19,0,0,0,0,0,0,0,0,5,11,0,0,0,16,100,100,100,0,0,0,0,0,113,413
ND4G,18,18,0,0,0,0,0,0,0,0,1,14,0,0,0,15,100,100,100,0,0,0,0,0,48,348
ND9Z,68,68,0,0,0,0,0,0,0,0,0,36,0,0,0,36,100,100,100,50,0,50,0,0,91,491
NE5DL,70,70,0,0,0,0,0,0,0,0,16,40,0,0,0,56,100,100,100,50,0,0,0,0,147,497
NG2H,116,116,0,0,0,0,0,0,3,12,34,37,2,0,0,88,100,100,100,50,0,0,0,0,137,487
NG9M,90,90,0,0,0,0,0,0,0,13,42,9,0,0,0,64,100,100,100,50,0,150,0,0,0,500
NJ0P,7,7,0,0,0,0,0,0,0,0,0,6,0,0,0,6,100,100,100,50,0,0,0,0,4,354
NK6A,81,81,0,0,0,0,0,0,0,0,7,57,1,0,0,65,100,100,100,0,0,0,0,0,144,444
NN5O,52,52,0,0,0,0,0,0,0,0,0,40,0,0,0,40,100,100,100,50,0,50,0,0,71,471
NO7DE,10,10,0,0,0,0,0,0,0,0,0,10,0,0,0,10,100,100,100,50,0,50,0,0,9,409
NO7E,17,17,0,0,0,0,0,0,0,0,1,16,0,0,0,17,100,100,100,50,0,0,0,0,221,571
NP4EG,20,20,0,0,0,0,0,0,0,0,0,20,0,0,0,20,100,100,100,0,0,0,0,0,70,370
NP4LW,5,5,0,0,0,0,0,0,0,0,0,5,0,0,0,5,100,100,100,0,0,0,0,0,0,300
NP4RA,15,15,0,0,0,0,0,0,0,0,0,12,0,0,0,12,100,100,100,0,0,0,0,0,78,378
NQ6N,116,116,0,0,0,0,0,0,0,34,0,43,0,0,0,77,100,100,100,50,0,100,0,0,215,665
NQ9A,13,13,0,0,0,0,0,0,0,0,2,10,0,0,0,12,100,100,100,0,0,0,0,0,20,320
NR4J,14,14,0,0,0,0,0,0,0,0,13,0,0,0,0,13,100,100,100,50,100,50,0,0,7,507
NS3C,44,44,0,0,0,0,0,0,0,0,3,25,0,0,0,28,100,100,100,50,0,0,0,0,62,412
NV1W,11,11,0,0,0,0,0,0,0,0,0,10,0,0,0,10,100,100,100,0,0,50,0,0,5,355
OM5UM,4,4,0,0,0,0,0,0,0,0,0,3,0,0,0,3,100,100,100,0,100,0,0,0,37,437
SV1QFV,41,41,0,0,0,0,0,0,0,0,0,29,0,0,0,29,100,100,100,0,0,0,0,0,299,599
SV1RVP,23,23,0,0,0,0,0,0,0,0,0,20,0,0,0,20,100,100,100,0,0,50,0,0,23,373
SV8CYR,33,33,0,0,0,0,0,0,0,0,0,1,0,0,0,1,100,100,100,50,0,0,0,0,16,366
SV8CYV,1,1,0,0,0,0,0,0,0,0,0,1,0,0,0,1,100,100,100,50,0,0,0,0,21,371
SV8GXQ,25,25,0,0,0,0,0,0,0,0,2,1,0,0,0,3,100,100,100,0,0,0,0,0,58,358
TG0AA,12,12,0,0,0,0,0,0,0,0,0,10,0,0,0,10,100,100,100,0,0,0,0,0,50,350
VA2KT,9,9,0,0,0,0,0,0,0,0,6,1,0,0,0,7,100,100,100,0,0,100,0,0,40,440
VA3EC,8,8,0,0,0,0,0,0,0,0,0,6,1,0,0,7,100,100,100,0,0,0,0,0,30,330
VA5LD,14,14,0,0,0,0,0,0,0,0,0,12,0,0,0,12,100,100,100,50,0,0,0,0,113,463
VA7NLF,11,11,0,0,0,0,0,0,0,0,4,6,0,0,0,10,100,100,100,0,0,0,0,0,0,300
VE2GT,5,5,0,0,0,0,0,0,0,0,0,5,0,0,0,5,100,100,100,50,0,0,0,0,0,350
VE3CV,42,42,0,0,0,0,0,0,6,17,0,9,0,0,0,32,100,100,100,0,100,0,0,0,58,458
VE3CWU,30,30,0,0,0,0,0,0,0,0,0,24,0,0,0,24,100,100,100,0,0,0,0,0,42,342
VE3HED,20,20,0,0,0,0,0,0,0,0,10,9,0,0,0,19,100,100,100,0,0,0,0,0,144,444
VE3KP,159,159,0,0,0,0,0,0,0,0,53,0,0,0,0,53,100,100,100,0,0,0,0,0,125,425
VE3MGY,122,122,0,0,0,0,0,0,8,17,37,10,0,0,0,72,100,100,100,50,0,200,0,0,151,701
VE3OSZ,31,31,0,0,0,0,0,0,0,0,14,4,0,0,0,18,100,100,100,0,0,0,0,0,33,333
VE3PVI,61,61,0,0,0,0,0,0,0,0,17,33,0,0,0,50,100,100,100,0,0,0,0,0,123,423
VE3UTT,41,41,0,0,0,0,0,0,0,0,5,30,1,0,0,36,100,100,100,0,0,150,0,0,298,748
VE3VPT,13,13,0,0,0,0,0,0,0,0,0,12,0,0,0,12,100,100,100,0,0,0,0,0,207,507
VE7CA,44,44,0,0,0,0,0,0,0,2,13,9,2,0,0,26,100,100,100,0,0,0,0,0,130,430
VE7IO,78,78,0,0,0,0,0,0,0,0,0,36,0,0,0,36,100,100,100,0,0,50,0,0,115,465
VE7NZ,1,1,0,0,0,0,0,0,0,1,0,0,0,0,0,1,100,100,100,50,0,0,0,0,251,601
VE9TFB,2,2,0,0,0,0,0,0,0,0,0,1,0,0,0,1,100,100,100,0,0,0,0,0,30,330
VU2IT,30,30,0,0,0,0,0,0,0,0,1,24,0,0,0,25,100,100,100,0,0,0,0,0,28,328
W0C,154,154,0,0,0,0,0,0,0,0,43,40,0,0,0,83,100,100,100,0,0,0,0,0,330,630
W0D,378,378,0,0,0,0,0,0,0,0,13,140,0,0,0,153,100,100,100,50,100,100,0,0,306,856
W0ECC,461,461,0,0,0,0,0,0,0,0,93,112,14,0,0,219,100,100,100,0,0,0,0,0,353,653
W0FL,112,112,0,0,0,0,0,0,0,0,25,35,0,0,0,60,100,100,100,0,0,0,0,0,82,382
W0GXA,26,26,0,0,0,0,0,0,0,0,0,20,3,0,0,23,100,100,100,0,0,0,0,0,45,345
W0IS,3,3,0,0,0,0,0,0,0,0,3,0,0,0,0,3,100,100,100,50,0,0,0,0,3,353
W0JJR,3,3,0,0,0,0,0,0,1,0,0,2,0,0,0,3,100,100,100,50,0,0,0,0,0,350
W0JTC,26,26,0,0,0,0,0,0,0,0,0,20,0,0,0,20,100,100,100,0,0,0,0,0,0,300
W0LGU,22,22,0,0,0,0,0,0,0,0,13,4,0,0,0,17,100,100,100,50,0,0,0,0,20,370
W0PWE,8,8,0,0,0,0,0,0,0,0,7,0,0,0,0,7,100,100,100,50,0,0,0,0,3,353
W1ANT,22,22,0,0,0,0,0,0,0,0,1,17,0,0,0,18,100,100,100,0,100,0,0,0,107,507
W1DGL,6,6,0,0,0,0,0,0,0,0,0,5,0,0,0,5,100,100,100,50,100,0,0,0,128,578
W1HP,22,22,0,0,0,0,0,0,0,0,15,1,0,0,0,16,100,100,100,0,0,0,0,0,43,343
W1HS,126,126,0,0,0,0,0,0,0,0,33,48,0,0,0,81,100,100,100,0,0,0,0,0,82,382
W1LEM,20,20,0,0,0,0,0,0,0,0,6,14,0,0,0,20,100,100,100,0,0,0,0,0,363,663
W1MJ,37,37,0,0,0,0,0,0,0,0,12,11,0,0,0,23,100,100,100,0,100,100,0,0,69,569
W1QK,56,56,0,0,0,0,0,0,1,1,13,35,1,0,0,51,100,100,100,50,0,0,0,0,95,445
W1SJ,479,479,0,0,0,0,0,0,0,5,57,166,0,0,0,228,100,100,100,50,100,150,0,0,384,984
W1TOD,16,16,0,0,0,0,0,0,0,0,8,7,0,0,0,15,100,100,100,50,0,0,0,0,0,350
W1UJ,349,349,0,0,0,0,0,0,0,0,30,132,6,1,0,169,100,100,100,50,0,0,0,0,388,738
W1ZT,21,21,0,0,0,0,0,0,0,0,8,13,0,0,0,21,100,100,100,50,0,50,0,0,66,466
W2DPT,15,15,0,0,0,0,0,0,1,3,9,0,0,0,0,13,100,100,100,50,0,0,0,0,18,368
W2HTI,19,19,0,0,0,0,0,0,0,0,0,16,0,0,0,16,100,100,100,0,0,0,0,0,0,300
W2KGY,20,20,0,0,0,0,0,0,0,0,17,1,0,0,0,18,100,100,100,0,0,0,0,0,0,300
W2NAF,39,39,0,0,0,0,0,0,0,1,18,18,0,0,0,37,100,100,100,0,0,0,0,0,1,301
W2NP,10,10,0,0,0,0,0,0,0,0,0,8,0,0,0,8,100,100,100,50,0,0,0,0,10,360
W2NPT,63,63,0,0,0,0,0,0,0,0,9,27,2,0,0,38,100,100,100,50,0,0,0,0,150,500
W2SFD,63,63,0,0,0,0,0,0,0,0,0,28,0,0,0,28,100,100,100,0,0,0,0,0,247,547
W2UDT,11,11,0,0,0,0,0,0,0,0,3,8,0,0,0,11,100,100,100,50,0,100,0,0,28,478
W3CB,26,26,0,0,0,0,0,0,0,0,22,0,0,0,0,22,100,100,100,50,0,50,0,0,34,434
W3DET,21,21,0,0,0,0,0,0,0,0,0,20,0,0,0,20,100,100,100,50,0,0,0,0,64,414
W3HMK-P,35,35,0,0,0,0,0,0,0,0,17,6,0,0,0,23,100,100,100,0,0,0,0,0,27,327
W3IUU,103,103,0,0,0,0,0,0,0,21,23,25,3,1,0,73,100,100,100,0,0,0,0,0,205,505
W3KWH,9,9,0,0,0,0,0,0,0,0,7,2,0,0,0,9,100,100,100,0,0,0,0,0,115,415
W3PR,17,17,0,0,0,0,0,0,0,0,8,8,0,0,0,16,100,100,100,50,0,0,0,0,27,377
W3RL,4,4,0,0,0,0,0,0,0,0,4,0,0,0,0,4,100,100,100,50,0,50,0,0,7,407
W3RLO,8,8,0,0,0,0,0,0,0,0,0,8,0,0,0,8,100,100,100,0,100,0,0,0,12,412
W3UL,25,25,0,0,0,0,0,0,0,0,16,2,0,0,0,18,100,100,100,50,0,0,0,0,43,393
W3ZIC,25,25,0,0,0,0,0,0,0,0,19,3,0,0,0,22,100,100,100,0,0,0,0,0,0,300
W4AU,16,16,0,0,0,0,0,0,0,0,5,9,0,0,0,14,100,100,100,0,0,0,0,0,34,334
W4BKM,25,25,0,0,0,0,0,0,0,0,1,18,0,0,0,19,100,100,100,0,0,0,0,0,0,300
W4CHI,60,60,0,0,0,0,0,0,0,1,26,17,5,2,0,51,100,100,100,50,0,0,0,0,723,1073
W4DFG,36,36,0,0,0,0,0,0,0,13,10,6,4,0,0,33,100,100,100,0,0,200,0,0,62,562
W4E,150,150,0,0,0,0,0,0,0,0,40,41,0,0,0,81,100,100,100,0,0,0,0,0,10,310
W4FEB,7,7,0,0,0,0,0,0,0,0,3,4,0,0,0,7,100,100,100,50,0,0,0,0,0,350
W4GHV,12,12,0,0,0,0,0,0,0,0,0,10,0,0,0,10,100,100,100,50,0,0,0,0,158,508
W4HS,180,180,0,0,0,0,0,0,0,0,0,97,0,0,0,97,100,100,100,0,0,50,0,0,229,579
W4JL,120,120,0,0,0,0,0,0,0,0,46,33,0,0,0,79,100,100,100,0,0,0,0,0,107,407
W4JTP,80,80,0,0,0,0,0,0,0,0,27,33,4,0,0,64,100,100,100,50,0,0,0,0,91,441
W4LID,25,25,0,0,0,0,0,0,0,0,13,12,0,0,0,25,100,100,100,0,0,0,0,0,0,300
W4MDV,12,12,0,0,0,0,0,0,0,0,0,12,0,0,0,12,100,100,100,50,0,0,0,0,9,359
W4PF,21,21,0,0,0,0,0,0,0,0,0,21,0,0,0,21,100,100,100,0,0,50,0,0,18,368
W4TMW,21,21,0,0,0,0,0,0,0,12,0,8,0,0,0,20,100,100,100,50,0,0,0,0,15,365
W4TTM,90,90,0,0,0,0,0,0,0,0,27,39,0,0,0,66,100,100,100,0,0,0,0,0,181,481
W5AC,150,150,0,0,0,0,0,0,0,0,0,79,0,0,0,79,100,100,100,50,0,0,0,0,0,350
W5FMH,200,200,0,0,0,0,0,0,0,0,24,89,19,1,0,133,100,100,100,0,0,0,0,0,255,555
W5GAD,301,301,0,0,0,0,0,0,0,0,18,149,1,0,0,168,100,100,100,50,0,0,0,0,279,629
W5JVR,34,34,0,0,0,0,0,0,0,0,8,17,0,0,0,25,100,100,100,50,0,0,0,0,21,371
W5MMW-VE3,55,55,0,0,0,0,0,0,0,0,0,33,0,0,0,33,100,100,100,0,0,0,0,0,41,341
W5QLF,26,26,0,0,0,0,0,0,0,0,0,24,0,0,0,24,100,100,100,0,0,50,0,0,45,395
W5QZ,20,20,0,0,0,0,0,0,0,0,0,16,0,0,0,16,100,100,100,50,0,50,0,0,0,400
W5RRR,12,12,0,0,0,0,0,0,0,0,7,5,0,0,0,12,100,100,100,50,100,100,0,0,26,576
W5TA,218,218,0,0,0,0,0,0,0,0,8,113,0,0,0,121,100,100,100,50,0,0,0,0,284,634
W6DEI,49,49,0,0,0,0,0,0,0,0,0,31,0,0,0,31,100,100,100,0,0,50,50,0,50,450
W6IHG,18,18,0,0,0,0,0,0,0,0,0,14,0,0,0,14,100,100,100,50,0,50,0,0,24,424
W6JTI,64,64,0,0,0,0,0,0,0,6,6,38,0,0,0,50,100,100,100,0,0,0,0,0,74,374
W6JWP,1,1,0,0,0,0,0,0,0,0,1,0,0,0,0,1,100,100,100,0,0,0,0,0,0,300
W6K,41,41,0,0,0,0,0,0,0,0,6,27,0,0,0,33,100,100,100,0,0,0,0,0,128,428
W6KRF,3,3,0,0,0,0,0,0,0,0,2,1,0,0,0,3,100,100,100,50,0,0,0,0,0,350
W6MRR,30,30,0,0,0,0,0,0,0,0,0,19,0,0,0,19,100,100,100,50,100,150,0,250,361,1211
W6MVM,22,22,0,0,0,0,0,0,0,0,0,19,0,0,0,19,100,100,100,50,0,0,0,0,28,378
W6RDF,360,360,0,0,0,0,0,0,0,0,5,156,8,0,0,169,100,100,100,50,0,150,0,0,245,745
W6SFI,21,21,0,0,0,0,0,0,0,0,0,21,0,0,0,21,100,100,100,0,0,0,0,0,26,326
W6SX,275,275,0,0,0,0,0,0,0,0,28,96,0,0,0,124,100,100,100,50,0,0,0,0,298,648
W6SZN,28,28,0,0,0,0,0,0,0,0,10,17,0,0,0,27,100,100,100,0,0,0,0,0,52,352
W6YX,217,217,0,0,0,0,0,0,0,0,22,114,8,0,0,144,100,100,100,0,0,150,0,0,264,714
W7AUM,80,80,0,0,0,0,0,0,0,0,0,68,0,0,0,68,100,100,100,0,0,0,0,0,0,300
W7BV,39,39,0,0,0,0,0,0,0,0,3,30,0,0,0,33,100,100,100,50,100,0,0,0,60,510
W7CGA,10,10,0,0,0,0,0,0,0,0,0,10,0,0,0,10,100,100,100,50,0,0,0,0,0,350
W7DGP,30,30,0,0,0,0,0,0,0,0,0,28,0,0,0,28,100,100,100,50,0,50,0,0,102,502
W7GF,28,28,0,0,0,0,0,0,0,3,10,13,0,0,0,26,100,100,100,0,0,0,0,0,18,318
W7GKF,101,101,0,0,0,0,0,0,0,0,10,66,0,0,0,76,100,100,100,0,0,0,0,0,126,426
W7IY,206,206,0,0,0,0,0,0,0,0,36,86,1,0,0,123,100,100,100,0,0,100,0,0,246,646
W7O,175,175,0,0,0,0,0,0,0,0,0,114,0,0,0,114,100,100,100,0,0,0,0,0,0,300
W7OSU,5,5,0,0,0,0,0,0,0,0,0,5,0,0,0,5,100,100,100,50,0,0,0,0,0,350
W7QC,81,81,0,0,0,0,0,0,0,0,41,0,0,0,0,41,100,100,100,50,0,0,0,0,78,428
W7QDM,138,138,0,0,0,0,0,0,0,0,14,73,0,0,0,87,100,100,100,0,100,0,0,0,186,586
W7RTM,18,18,0,0,0,0,0,0,0,1,4,11,0,0,0,16,100,100,100,0,0,0,0,0,0,300
W7SE,319,319,0,0,0,0,0,0,0,0,0,139,0,0,0,139,100,100,100,0,0,0,0,0,143,443
W7TR,21,21,0,0,0,0,0,0,0,0,2,18,0,0,0,20,100,100,100,0,100,0,0,0,29,429
W7VAS,16,16,0,0,0,0,0,0,0,0,0,15,0,0,0,15,100,100,100,50,0,50,0,0,63,463
W7VXS,53,53,0,0,0,0,0,0,0,0,0,40,0,0,0,40,100,100,100,50,0,0,0,0,255,605
W7WEC,66,66,0,0,0,0,0,0,0,0,0,23,0,0,0,23,100,100,100,0,0,0,0,0,16,316
W7WSV,23,23,0,0,0,0,0,0,0,0,3,18,0,0,0,21,100,100,100,50,0,0,0,0,16,366
W7YG,4,4,0,0,0,0,0,0,0,0,0,4,0,0,0,4,100,100,100,0,0,0,0,0,0,300
W7ZRC,28,28,0,0,0,0,0,0,0,0,14,13,0,0,0,27,100,100,100,50,0,50,0,0,42,442
W8AJS,37,37,0,0,0,0,0,0,0,0,0,30,0,0,0,30,100,100,100,50,0,50,0,0,93,493
W8DSB,3,3,0,0,0,0,0,0,0,0,1,2,0,0,0,3,100,100,100,0,0,0,0,0,207,507
W8EDU,194,194,0,0,0,0,0,0,0,0,71,3,0,0,0,74,100,100,100,50,0,0,0,0,81,431
W8HNI,95,95,0,0,0,0,0,0,0,5,25,27,0,0,0,57,100,100,100,50,0,0,0,0,88,438
W8KA,251,251,0,0,0,0,0,0,0,0,0,130,2,0,0,132,100,100,100,0,0,100,0,0,237,637
W8SBH,37,37,0,0,0,0,0,0,0,0,18,8,0,0,0,26,100,100,100,50,0,0,0,0,0,350
W8TK,70,70,0,0,0,0,0,0,0,0,3,46,3,1,0,53,100,100,100,50,0,0,0,0,58,408
W8WDW,1,1,0,0,0,0,0,0,0,0,0,0,0,0,0,0,100,100,100,50,0,0,0,0,0,350
W9AKS,15,15,0,0,0,0,0,0,0,0,0,11,0,0,0,11,100,100,100,50,0,0,0,0,38,388
W9AV,260,260,0,0,0,0,0,0,0,0,20,105,0,0,0,125,100,100,100,50,0,0,0,0,77,427
W9BBF,61,61,0,0,0,0,0,0,0,0,0,35,0,0,0,35,100,100,100,50,100,50,0,0,355,855
W9CEQ,19,19,0,0,0,0,0,0,0,0,4,15,0,0,0,19,100,100,100,50,100,100,0,0,0,550
W9EO,42,42,0,0,0,0,0,0,0,0,6,32,0,0,0,38,100,100,100,50,0,100,0,0,23,473
W9FFA,21,21,0,0,0,0,0,0,0,0,1,16,0,0,0,17,100,100,100,0,0,0,0,0,14,314
W9XT,210,210,0,0,0,0,0,0,0,19,59,47,3,0,0,128,100,100,100,0,0,200,0,0,272,772
W9XY,445,445,0,0,0,0,0,0,0,0,51,152,2,0,0,205,100,100,100,50,0,0,0,0,302,652
WA1FCN,216,216,0,0,0,0,0,0,0,5,62,72,0,0,0,139,100,100,100,0,0,0,0,0,299,599
WA1OUI,26,26,0,0,0,0,0,0,0,0,0,25,0,0,0,25,100,100,100,50,0,0,0,0,63,413
WA1SAY,88,88,0,0,0,0,0,0,0,0,11,53,0,0,0,64,100,100,100,50,0,100,0,0,41,491
WA3AAN,52,52,0,0,0,0,0,0,0,2,17,18,1,0,0,38,100,100,100,50,0,200,0,0,76,626
WA3AER,57,57,0,0,0,0,0,0,0,0,18,22,0,0,0,40,100,100,100,50,0,100,0,0,51,501
WA4CZD,1,1,0,0,0,0,0,0,0,0,0,0,0,0,0,0,100,100,100,50,0,0,0,0,0,350
WA4IPU,77,77,0,0,0,0,0,0,0,0,2,52,0,0,0,54,100,100,100,50,0,0,0,0,31,381
WA4MLD,50,50,0,0,0,0,0,0,0,0,19,18,0,0,0,37,100,100,100,0,0,0,0,0,48,348
WA4VKA,7,7,0,0,0,0,0,0,0,0,1,4,0,0,0,5,100,100,100,0,0,100,0,0,0,400
WA5KBH,48,48,0,0,0,0,0,0,0,0,0,39,0,0,0,39,100,100,100,0,0,0,0,0,0,300
WA5LXS,36,36,0,0,0,0,0,0,0,0,8,23,0,0,0,31,100,100,100,50,0,100,0,0,25,475
WA5TVO,48,48,0,0,0,0,0,0,0,0,14,11,1,0,0,26,100,100,100,50,0,0,0,0,130,480
WA7BAM,10,10,0,0,0,0,0,0,0,0,0,10,0,0,0,10,100,100,100,50,0,0,0,0,0,350
WA7DHQ,10,10,0,0,0,0,0,0,0,0,0,10,0,0,0,10,100,100,100,0,0,0,0,0,0,300
WA7GIL,41,41,0,0,0,0,0,0,0,0,0,29,0,0,0,29,100,100,100,0,0,0,0,0,0,300
WA7YXY,8,8,0,0,0,0,0,0,0,0,3,4,0,0,0,7,100,100,100,50,100,100,0,0,0,550
WA9LEY,66,66,0,0,0,0,0,0,0,0,22,35,0,0,0,57,100,100,100,0,0,0,0,0,81,381
WA9PYH,28,28,0,0,0,0,0,0,0,2,9,15,0,0,0,26,100,100,100,50,0,150,0,0,40,540
WB0IWG,17,17,0,0,0,0,0,0,0,0,4,12,0,0,0,16,100,100,100,0,0,0,0,0,0,300
WB0TEV-M,15,15,0,0,0,0,0,0,0,0,0,12,0,0,0,12,100,100,100,0,0,0,0,0,20,320
WB1CZX,5,5,0,0,0,0,0,0,0,0,0,5,0,0,0,5,100,100,100,50,0,0,0,0,4,354
WB2COY,16,16,0,0,0,0,0,0,0,0,0,13,0,0,0,13,100,100,100,50,0,0,0,0,18,368
WB3D,11,11,0,0,0,0,0,0,0,0,0,10,0,0,0,10,100,100,100,0,100,0,0,0,8,408
WB3LHD,100,100,0,0,0,0,0,0,0,0,0,0,0,0,0,0,100,100,100,50,0,50,0,0,283,683
WB5UAA,13,13,0,0,0,0,0,0,0,0,0,12,0,0,0,12,100,100,100,50,0,50,50,0,9,459
WB6OTS,100,100,0,0,0,0,0,0,0,0,0,67,1,0,0,68,100,100,100,50,100,100,0,0,185,735
WB9CIF,60,60,0,0,0,0,0,0,0,0,19,34,2,0,0,55,100,100,100,50,100,100,0,0,118,668
WB9HCO,18,18,0,0,0,0,0,0,0,0,1,16,0,0,0,17,100,100,100,50,100,0,0,0,0,450
WB9HFK,155,155,0,0,0,0,0,0,0,5,67,0,0,0,0,72,100,100,100,0,0,0,0,0,121,421
WB9IFE,5,5,0,0,0,0,0,0,0,0,0,5,0,0,0,5,100,100,100,0,0,0,0,0,0,300
WB9MSM,106,106,0,0,0,0,0,0,0,0,18,50,1,0,0,69,100,100,100,50,100,0,0,0,253,703
WB9QAF,39,39,0,0,0,0,0,0,0,0,1,26,0,0,0,27,100,100,100,50,0,0,0,0,31,381
WC0WB,36,36,0,0,0,0,0,0,0,0,0,15,0,0,0,15,100,100,100,0,0,0,0,0,36,336
WD5ABC,1,1,0,0,0,0,0,0,0,0,0,0,1,0,0,1,100,100,100,50,0,50,0,0,11,411
WD8RIF-4,22,22,0,0,0,0,0,0,0,0,9,12,0,0,0,21,100,100,100,0,0,0,0,0,12,312
WF4W,123,123,0,0,0,0,0,0,0,0,50,38,0,0,0,88,100,100,100,50,0,0,0,0,140,490
WG2Z,26,26,0,0,0,0,0,0,0,0,0,24,0,0,0,24,100,100,100,50,0,0,0,0,412,762
WH7W,16,16,0,0,0,0,0,0,0,0,0,14,0,0,0,14,100,100,100,50,0,50,0,0,61,461
WI2W,52,52,0,0,0,0,0,0,0,0,17,20,0,0,0,37,100,100,100,50,0,0,0,0,122,472
WI7P,3,3,0,0,0,0,0,0,0,0,2,0,0,0,0,2,100,100,100,50,0,0,0,0,0,350
WM2Z,32,32,0,0,0,0,0,0,0,0,0,24,0,0,0,24,100,100,100,50,0,0,0,0,17,367
WM4AA,19,19,0,0,0,0,0,0,0,3,1,14,0,0,0,18,100,100,100,50,0,0,0,0,41,391
WN4AFP,86,86,0,0,0,0,0,0,0,0,22,3,0,0,0,25,100,100,100,0,0,0,0,0,47,347
WW1ME,62,62,0,0,0,0,0,0,1,5,9,29,0,0,0,44,100,100,100,0,0,0,0,0,90,390
WW4SF,47,47,0,0,0,0,0,0,0,0,15,23,0,0,0,38,100,100,100,50,0,0,0,0,54,404
WX0M,9,9,0,0,0,0,0,0,0,0,0,9,0,0,0,9,100,100,100,50,0,50,0,0,84,484
WX8V,51,51,0,0,0,0,0,0,0,4,23,14,0,0,0,41,100,100,100,50,0,0,0,0,50,400
XE1B,73,73,0,0,0,0,0,0,0,0,0,52,0,0,0,52,100,100,100,0,0,50,0,0,1,351
XE2B,13,13,0,0,0,0,0,0,0,0,0,12,0,0,0,12,100,100,100,0,0,50,0,0,32,382
YO3APJ,38,38,0,0,0,0,0,0,0,0,0,28,0,0,0,28,100,100,100,0,0,0,0,0,145,445
YO3GNF,4,4,0,0,0,0,0,0,0,0,0,4,0,0,0,4,100,100,100,0,0,0,0,0,165,465
